//MAP CONVERTED BY dmm2tgm.py THIS HEADER COMMENT PREVENTS RECONVERSION, DO NOT REMOVE
"aP" = (
/obj/structure/roguetent,
/turf/open/floor/rogue/cobble,
/area/rogue/outdoors/woods/churchfort/basement)
"cI" = (
/mob/living/simple_animal/hostile/retaliate/rogue/orc/ranged,
/turf/open/floor/rogue/grass,
/area/rogue/outdoors/woods/churchfort/basement)
"cR" = (
/obj/structure/bed/rogue/inn/hay,
/obj/item/bedsheet/rogue/pelt,
/turf/open/floor/rogue/twig,
/area/rogue/outdoors/woods/churchfort/basement)
"da" = (
/obj/structure/flora/roguegrass/water,
/turf/open/water/pond,
/area/rogue/outdoors/woods/churchfort/basement)
"ho" = (
/obj/structure/mineral_door/wood/donjon/stone{
	dir = 4;
	name = "South-West Tower"
	},
/turf/open/floor/rogue/ruinedwood,
/area/rogue/outdoors/woods/churchfort/basement)
"hp" = (
/obj/machinery/light/rogue/torchholder/l,
/turf/open/floor/rogue/twig,
/area/rogue/outdoors/woods/churchfort/basement)
"ih" = (
/mob/living/carbon/human/species/goblin/npc/ambush/cave,
/turf/open/floor/rogue/ruinedwood,
/area/rogue/outdoors/woods/churchfort/basement)
"iu" = (
/obj/structure/bars/passage{
	redstone_id = "church_keep_main_gate";
	max_integrity = 9000
	},
/turf/open/floor/rogue/cobble,
/area/rogue/outdoors/woods/churchfort/basement)
"iR" = (
/obj/structure/fluff/railing/border{
	dir = 1;
	icon_state = "border"
	},
/obj/structure/flora/ausbushes/lavendergrass,
/obj/structure/flora/ausbushes/ppflowers,
/turf/open/floor/rogue/grass,
/area/rogue/outdoors/woods/churchfort/basement)
"jk" = (
/turf/open/floor/rogue/blocks/bluestone,
/area/rogue/outdoors/woods/churchfort/basement)
"lZ" = (
/mob/living/simple_animal/hostile/retaliate/rogue/orc/orc2,
/turf/open/floor/rogue/blocks/bluestone,
/area/rogue/outdoors/woods/churchfort/basement)
"md" = (
/obj/machinery/light/rogue/torchholder/l,
/turf/open/floor/rogue/cobble,
/area/rogue/outdoors/woods/churchfort/basement)
"mj" = (
/obj/effect/decal/cobbleedge{
	dir = 1;
	icon_state = "borderfall"
	},
/obj/effect/decal/cobbleedge{
	dir = 6;
	icon_state = "borderfall";
	pixel_x = 27
	},
/turf/open/floor/rogue/grass,
/area/rogue/outdoors/woods/churchfort/basement)
"mF" = (
/obj/structure/trap/spider,
/turf/open/floor/rogue/twig,
/area/rogue/outdoors/woods/churchfort/basement)
"oO" = (
/obj/effect/decal/mossy{
	dir = 4
	},
/turf/open/floor/rogue/dirt/road,
/area/rogue/outdoors/woods/churchfort/basement)
"pK" = (
/obj/effect/decal/cobbleedge{
	dir = 1;
	icon_state = "borderfall"
	},
/turf/open/floor/rogue/dirt/road,
/area/rogue/outdoors/woods/churchfort/basement)
"qE" = (
/obj/effect/decal/cleanable/cobweb{
	icon_state = "cobweb2"
	},
/turf/open/floor/rogue/ruinedwood,
/area/rogue/outdoors/woods/churchfort/basement)
"qH" = (
/obj/structure/bars/passage{
	redstone_id = "church_keep_side_gate";
	max_integrity = 9000
	},
/turf/open/floor/rogue/cobble,
/area/rogue/outdoors/woods/churchfort/basement)
"qP" = (
/mob/living/simple_animal/hostile/retaliate/rogue/orc/spear2,
/turf/open/floor/rogue/dirt/road,
/area/rogue/outdoors/woods/churchfort/basement)
"rp" = (
/mob/living/carbon/human/species/goblin/npc/ambush/cave,
/turf/open/floor/rogue/cobble,
/area/rogue/outdoors/woods/churchfort/basement)
"rq" = (
/obj/structure/fluff/walldeco/katholikos_banner{
	pixel_y = 25
	},
/obj/effect/decal/cobbleedge{
	dir = 1;
	icon_state = "borderfall"
	},
/turf/open/floor/rogue/dirt/road,
/area/rogue/outdoors/woods/churchfort/basement)
"rv" = (
/obj/structure/mineral_door/wood/donjon/stone{
	dir = 4;
	name = "Dormitories"
	},
/turf/open/floor/rogue/twig,
/area/rogue/outdoors/woods/churchfort/basement)
"tl" = (
/obj/effect/decal/cleanable/cobweb,
/turf/open/floor/rogue/ruinedwood,
/area/rogue/outdoors/woods/churchfort/basement)
"ts" = (
/obj/effect/decal/cobbleedge{
	dir = 1;
	icon_state = "borderfall"
	},
/obj/effect/decal/cobbleedge{
	dir = 10;
	icon_state = "borderfall";
	pixel_x = -27
	},
/turf/open/floor/rogue/grass,
/area/rogue/outdoors/woods/churchfort/basement)
"tV" = (
/turf/closed/wall/mineral/rogue/stone/moss,
/area/rogue/outdoors/woods/churchfort/basement)
"uk" = (
/obj/machinery/light/rogue/firebowl/stump,
/turf/open/floor/rogue/grass,
/area/rogue/outdoors/woods/churchfort/basement)
"vj" = (
/obj/structure/bed/rogue/bedroll,
/turf/open/floor/rogue/ruinedwood,
/area/rogue/outdoors/woods/churchfort/basement)
"yr" = (
/turf/closed/mineral/random/rogue,
/area/rogue/outdoors/woods/churchfort/basement)
"yA" = (
/turf/closed/wall/mineral/rogue/tent,
/area/rogue/outdoors/woods/churchfort/basement)
"yU" = (
/obj/structure/roguetent,
/turf/open/floor/rogue/ruinedwood,
/area/rogue/outdoors/woods/churchfort/basement)
"zC" = (
/obj/effect/decal/mossy{
	dir = 1
	},
/turf/open/floor/rogue/grass,
/area/rogue/outdoors/woods/churchfort/basement)
"zR" = (
/obj/structure/mineral_door/wood/donjon/stone{
	name = "South-West Tower"
	},
/turf/open/floor/rogue/ruinedwood,
/area/rogue/outdoors/woods/churchfort/basement)
"AY" = (
/obj/structure/fluff/railing/border{
	dir = 4
	},
/obj/structure/fluff/railing/border{
	dir = 8
	},
/turf/open/transparent/openspace,
/area/rogue/outdoors/woods/churchfort/basement)
"Bo" = (
/obj/structure/closet/crate/roguecloset/dark,
/obj/item/clothing/shoes/roguetown/sandals,
/obj/item/clothing/shoes/roguetown/sandals,
/obj/item/clothing/suit/roguetown/shirt/tunic/random,
/obj/item/clothing/suit/roguetown/shirt/tunic/random,
/obj/item/clothing/shoes/roguetown/sandals,
/obj/item/clothing/shoes/roguetown/sandals,
/obj/item/clothing/suit/roguetown/shirt/tunic/random,
/obj/item/clothing/suit/roguetown/shirt/tunic/random,
/turf/open/floor/rogue/twig,
/area/rogue/outdoors/woods/churchfort/basement)
"Bu" = (
/obj/structure/stairs/stone,
/obj/structure/fluff/railing/border{
	dir = 8
	},
/obj/structure/fluff/railing/border{
	dir = 4
	},
/turf/open/floor/rogue/ruinedwood,
/area/rogue/outdoors/woods/churchfort/basement)
"BL" = (
/obj/effect/decal/cobbleedge{
	dir = 1;
	icon_state = "borderfall"
	},
/obj/effect/decal/cobbleedge{
	dir = 10;
	icon_state = "borderfall";
	pixel_x = -27
	},
/turf/open/floor/rogue/dirt/road,
/area/rogue/outdoors/woods/churchfort/basement)
"BT" = (
/obj/structure/fluff/railing/border{
	dir = 8;
	icon_state = "border"
	},
/obj/structure/fluff/railing/border,
/obj/structure/flora/ausbushes/lavendergrass,
/obj/structure/flora/ausbushes/ywflowers,
/turf/open/floor/rogue/grass,
/area/rogue/outdoors/woods/churchfort/basement)
"Ch" = (
/obj/structure/fluff/railing/border,
/obj/structure/flora/ausbushes/lavendergrass,
/obj/structure/flora/ausbushes/ppflowers,
/obj/item/clothing/head/peaceflower{
	pixel_y = 5
	},
/turf/open/floor/rogue/grass,
/area/rogue/outdoors/woods/churchfort/basement)
"CA" = (
/turf/open/water/pond,
/area/rogue/outdoors/woods/churchfort/basement)
"CW" = (
/turf/closed/wall/mineral/rogue/stone,
/area/rogue/outdoors/woods/churchfort/basement)
"CY" = (
/obj/structure/bars/passage{
	redstone_id = "church_keep_courtyard_gate_1";
	max_integrity = 9000
	},
/turf/open/floor/rogue/blocks/bluestone,
/area/rogue/outdoors/woods/churchfort/basement)
"Dz" = (
/turf/open/floor/rogue/dirt/road,
/area/rogue/outdoors/woods/churchfort/basement)
"DX" = (
/turf/open/floor/rogue/ruinedwood,
/area/rogue/outdoors/woods/churchfort/basement)
"DZ" = (
/obj/item/natural/stone,
/obj/machinery/light/rogue/torchholder/r,
/turf/open/floor/rogue/cobble,
/area/rogue/outdoors/woods/churchfort/basement)
"FR" = (
/obj/effect/decal/cobbleedge{
	dir = 1;
	icon_state = "borderfall"
	},
/turf/open/floor/rogue/grass,
/area/rogue/outdoors/woods/churchfort/basement)
"GS" = (
/obj/structure/bars/grille{
	max_integrity = 5000;
	density = 1
	},
/turf/open/floor/rogue/blocks/bluestone,
/area/rogue/outdoors/woods/churchfort/basement)
"Hw" = (
/obj/structure/fluff/walldeco/katholikos_banner{
	pixel_y = 25
	},
/obj/effect/decal/cobbleedge{
	dir = 1;
	icon_state = "borderfall"
	},
/turf/open/floor/rogue/grass,
/area/rogue/outdoors/woods/churchfort/basement)
"Ia" = (
/obj/effect/decal/cobbleedge{
	dir = 1;
	icon_state = "borderfall"
	},
/obj/effect/decal/cobbleedge{
	dir = 6;
	icon_state = "borderfall";
	pixel_x = 27
	},
/turf/open/floor/rogue/dirt/road,
/area/rogue/outdoors/woods/churchfort/basement)
"IA" = (
/obj/structure/bars/passage{
	redstone_id = "church_keep_main_gate";
	max_integrity = 9000
	},
/turf/open/floor/rogue/blocks/bluestone,
/area/rogue/outdoors/woods/churchfort/basement)
"KC" = (
/turf/open/floor/rogue/cobble,
/area/rogue/outdoors/woods/churchfort/basement)
"KE" = (
/obj/machinery/light/rogue/torchholder/l,
/turf/open/floor/rogue/ruinedwood,
/area/rogue/outdoors/woods/churchfort/basement)
"KP" = (
/obj/structure/flora/roguetree/wise,
/obj/structure/flora/ausbushes/lavendergrass,
/turf/open/floor/rogue/grass,
/area/rogue/outdoors/woods/churchfort/basement)
"Lb" = (
/turf/open/floor/rogue/grass,
/area/rogue/outdoors/woods/churchfort/basement)
"Lj" = (
/obj/machinery/light/rogue/torchholder/l,
/turf/open/floor/rogue/blocks/bluestone,
/area/rogue/outdoors/woods/churchfort/basement)
"Na" = (
/obj/machinery/light/rogue/torchholder/c,
/turf/open/floor/rogue/blocks/bluestone,
/area/rogue/outdoors/woods/churchfort/basement)
"NP" = (
/obj/structure/lever{
	name = "gate lever";
	redstone_id = "church_keep_side_gate"
	},
/turf/open/floor/rogue/ruinedwood,
/area/rogue/outdoors/woods/churchfort/basement)
"On" = (
/obj/effect/decal/mossy{
	dir = 8
	},
/turf/open/floor/rogue/grass,
/area/rogue/outdoors/woods/churchfort/basement)
"OB" = (
/obj/item/natural/rock,
/turf/open/floor/rogue/cobble,
/area/rogue/outdoors/woods/churchfort/basement)
"Rm" = (
/obj/structure/roguewindow,
/turf/open/floor/rogue/blocks/bluestone,
/area/rogue/outdoors/woods/churchfort/basement)
"TI" = (
/obj/structure/fluff/railing/border{
	dir = 8;
	icon_state = "border"
	},
/obj/structure/flora/ausbushes/lavendergrass,
/obj/structure/flora/ausbushes/brflowers,
/turf/open/floor/rogue/grass,
/area/rogue/outdoors/woods/churchfort/basement)
"TM" = (
/obj/structure/stairs/stone{
	dir = 1
	},
/turf/open/floor/rogue/cobble,
/area/rogue/outdoors/woods/churchfort/basement)
"Uz" = (
/obj/machinery/light/rogue/torchholder/r,
/turf/open/floor/rogue/ruinedwood,
/area/rogue/outdoors/woods/churchfort/basement)
"UE" = (
/mob/living/carbon/human/species/goblin/npc/ambush/cave,
/turf/open/floor/rogue/blocks/bluestone,
/area/rogue/outdoors/woods/churchfort/basement)
"Xd" = (
/turf/open/floor/rogue/twig,
/area/rogue/outdoors/woods/churchfort/basement)
"XS" = (
/mob/living/simple_animal/hostile/retaliate/rogue/orc/spear2,
/turf/open/floor/rogue/blocks/bluestone,
/area/rogue/outdoors/woods/churchfort/basement)
"XU" = (
/obj/item/natural/stone,
/obj/effect/decal/cobbleedge{
	dir = 1;
	icon_state = "borderfall"
	},
/turf/open/floor/rogue/cobble,
/area/rogue/outdoors/woods/churchfort/basement)
"Yq" = (
/obj/structure/fluff/walldeco/katholikos_banner/gani{
	pixel_x = -31
	},
/obj/effect/decal/mossy{
	dir = 4
	},
/turf/open/floor/rogue/dirt/road,
/area/rogue/outdoors/woods/churchfort/basement)
"Zo" = (
/obj/effect/decal/mossy{
	dir = 4
	},
/obj/effect/decal/mossy,
/turf/open/floor/rogue/dirt/road,
/area/rogue/outdoors/woods/churchfort/basement)
"ZU" = (
/obj/structure/fluff/railing/border{
	dir = 1;
	icon_state = "border"
	},
/obj/structure/fluff/railing/border{
	dir = 8;
	icon_state = "border"
	},
/obj/structure/flora/ausbushes/lavendergrass,
/obj/structure/flora/roguegrass/pyroclasticflowers,
/turf/open/floor/rogue/grass,
/area/rogue/outdoors/woods/churchfort/basement)

(1,1,1) = {"
yr
yr
yr
yr
yr
tV
tV
CW
CW
qH
CW
tV
aP
yA
ts
"}
(2,1,1) = {"
tV
tV
CW
CW
CW
tV
tl
KE
DX
DX
DX
md
KC
aP
XU
"}
(3,1,1) = {"
cR
mF
cR
hp
cR
tV
yA
yA
yA
rp
KC
DX
DX
tV
rq
"}
(4,1,1) = {"
Xd
mF
Xd
mF
Bo
CW
vj
DX
yU
DX
DX
KC
NP
CW
Ia
"}
(5,1,1) = {"
rv
CW
rv
tV
CW
CW
CW
CW
CW
DX
DX
DX
DX
qH
TM
"}
(6,1,1) = {"
KC
jk
KC
Lj
jk
CW
CW
AY
Bu
DX
ih
DX
DX
qH
TM
"}
(7,1,1) = {"
KC
jk
XS
KC
KC
zR
DX
DX
DX
DX
DX
DX
DX
CW
BL
"}
(8,1,1) = {"
lZ
KC
KC
jk
jk
Rm
DX
ih
OB
KC
DX
DX
DX
tV
rq
"}
(9,1,1) = {"
tV
CW
CW
GS
tV
tV
qE
DZ
DX
DX
DX
Uz
DX
tV
pK
"}
(10,1,1) = {"
oO
Yq
oO
Zo
zC
tV
CW
tV
Rm
ho
Rm
CW
tV
tV
mj
"}
(11,1,1) = {"
On
On
On
On
Lb
da
CA
CW
KC
jk
jk
CW
FR
Lb
Lb
"}
(12,1,1) = {"
Lb
Lb
Lb
Lb
Lb
Lb
da
GS
KC
jk
jk
CW
Hw
uk
Lb
"}
(13,1,1) = {"
Dz
Dz
Dz
Lb
Lb
Lb
Lb
CW
Na
UE
KC
tV
mj
Lb
Lb
"}
(14,1,1) = {"
ZU
TI
BT
Dz
cI
Dz
Dz
CY
jk
KC
jk
IA
TM
Dz
Dz
"}
(15,1,1) = {"
iR
KP
Ch
qP
Dz
Dz
Dz
CY
KC
KC
jk
iu
TM
KC
KC
"}
