//MAP CONVERTED BY dmm2tgm.py THIS HEADER COMMENT PREVENTS RECONVERSION, DO NOT REMOVE
"ac" = (
/obj/effect/decal/cleanable/blood/tracks{
	dir = 4
	},
/turf/open/floor/rogue/blocks/bluestone,
/area/rogue/outdoors/woods/churchfort/basement)
"al" = (
/obj/machinery/light/rogue/hearth,
/obj/item/cooking/pan,
/obj/effect/decal/cleanable/cobweb,
/turf/open/floor/rogue/tile/checkeralt,
/area/rogue/outdoors/woods/churchfort/basement)
"bw" = (
/obj/structure/fermenting_barrel/blessedwine,
/turf/open/floor/rogue/blocks/green,
/area/rogue/outdoors/woods/churchfort/basement)
"cK" = (
/obj/structure/bed/rogue/inn/hay,
/obj/item/bedsheet/rogue/pelt,
/obj/effect/decal/cleanable/blood,
/turf/open/floor/rogue/twig,
/area/rogue/outdoors/woods/churchfort/basement)
"cS" = (
/turf/open/floor/carpet/red,
/area/rogue/outdoors/woods/churchfort/basement)
"cT" = (
/obj/effect/spawner/lootdrop/roguetown/alcohol/expensive,
/turf/open/floor/rogue/blocks/green,
/area/rogue/outdoors/woods/churchfort/basement)
"dk" = (
/obj/effect/decal/cleanable/blood/tracks{
	dir = 10
	},
/turf/open/floor/rogue/ruinedwood,
/area/rogue/outdoors/woods/churchfort/basement)
"dB" = (
/obj/effect/decal/mossy,
/turf/open/floor/rogue/grass,
/area/rogue/outdoors/woods/churchfort/basement)
"dI" = (
/turf/open/transparent/openspace,
/area/rogue/outdoors/woods/churchfort/basement)
"ec" = (
/obj/structure/fluff/walldeco/katholikos_banner{
	pixel_y = 25
	},
/turf/open/floor/rogue/blocks/bluestone,
/area/rogue/outdoors/woods/churchfort/basement)
"fv" = (
/obj/structure/closet/crate/chest/crate,
/obj/item/reagent_containers/food/snacks/grown/onion/rogue,
/obj/item/reagent_containers/food/snacks/grown/onion/rogue,
/obj/item/reagent_containers/food/snacks/grown/onion/rogue,
/obj/item/reagent_containers/food/snacks/grown/onion/rogue,
/obj/item/reagent_containers/food/snacks/grown/cabbage/rogue,
/obj/item/reagent_containers/food/snacks/grown/cabbage/rogue,
/obj/item/reagent_containers/food/snacks/grown/cabbage/rogue,
/obj/item/reagent_containers/food/snacks/grown/cabbage/rogue,
/obj/item/reagent_containers/food/snacks/grown/potato/rogue,
/obj/item/reagent_containers/food/snacks/grown/potato/rogue,
/obj/item/reagent_containers/food/snacks/grown/potato/rogue,
/obj/item/reagent_containers/food/snacks/grown/potato/rogue,
/obj/item/reagent_containers/food/snacks/grown/berries/rogue,
/obj/item/reagent_containers/food/snacks/grown/berries/rogue,
/obj/item/reagent_containers/food/snacks/grown/berries/rogue,
/obj/item/reagent_containers/food/snacks/grown/berries/rogue,
/obj/effect/decal/cleanable/cobweb{
	icon_state = "cobweb2"
	},
/turf/open/floor/rogue/blocks/green,
/area/rogue/outdoors/woods/churchfort/basement)
"gG" = (
/mob/living/carbon/human/species/goblin/npc/ambush/cave,
/turf/open/floor/rogue/ruinedwood,
/area/rogue/outdoors/woods/churchfort/basement)
"hA" = (
/obj/effect/decal/cleanable/cobweb{
	icon_state = "cobweb2"
	},
/turf/open/floor/rogue/blocks/bluestone,
/area/rogue/outdoors/woods/churchfort/basement)
"hD" = (
/obj/machinery/light/rogue/hearth,
/obj/item/reagent_containers/glass/bucket/pot,
/obj/machinery/light/rogue/torchholder/l,
/turf/open/floor/rogue/tile/checkeralt,
/area/rogue/outdoors/woods/churchfort/basement)
"if" = (
/obj/structure/closet/crate/chest/crate,
/obj/item/reagent_containers/food/snacks/grown/wheat,
/obj/item/reagent_containers/food/snacks/grown/wheat,
/obj/item/reagent_containers/food/snacks/grown/wheat,
/obj/item/reagent_containers/food/snacks/grown/wheat,
/obj/item/reagent_containers/food/snacks/grown/wheat,
/obj/item/reagent_containers/food/snacks/grown/wheat,
/obj/item/reagent_containers/food/snacks/grown/oat,
/obj/item/reagent_containers/food/snacks/grown/oat,
/obj/item/reagent_containers/food/snacks/grown/oat,
/obj/item/reagent_containers/food/snacks/grown/oat,
/obj/item/reagent_containers/food/snacks/grown/oat,
/obj/item/reagent_containers/food/snacks/grown/oat,
/turf/open/floor/rogue/blocks/green,
/area/rogue/outdoors/woods/churchfort/basement)
"iu" = (
/obj/effect/decal/mossy{
	dir = 4
	},
/turf/open/floor/rogue/grass,
/area/rogue/outdoors/woods/churchfort/basement)
"iD" = (
/obj/structure/mineral_door/wood/donjon/stone{
	dir = 1;
	name = "North-East Tower"
	},
/obj/effect/decal/cleanable/blood/tracks,
/turf/open/floor/rogue/ruinedwood,
/area/rogue/outdoors/woods/churchfort/basement)
"iV" = (
/obj/structure/stairs/stone,
/turf/open/floor/rogue/blocks/bluestone,
/area/rogue/outdoors/woods/churchfort/basement)
"kn" = (
/obj/structure/bars/grille{
	max_integrity = 5000;
	density = 1
	},
/turf/open/floor/rogue/blocks/bluestone,
/area/rogue/outdoors/woods/churchfort/basement)
"kU" = (
/obj/effect/decal/cleanable/blood/tracks{
	dir = 5
	},
/turf/open/floor/rogue/ruinedwood,
/area/rogue/outdoors/woods/churchfort/basement)
"lk" = (
/turf/open/floor/rogue/blocks/bluestone,
/area/rogue/outdoors/woods/churchfort/basement)
"lC" = (
/mob/living/carbon/human/species/goblin/npc/ambush/cave,
/turf/open/floor/carpet/red,
/area/rogue/outdoors/woods/churchfort/basement)
"lK" = (
/obj/effect/spawner/lootdrop/roguetown/alcohol/cheap,
/turf/open/floor/rogue/ruinedwood,
/area/rogue/outdoors/woods/churchfort/basement)
"nq" = (
/obj/item/paper{
	info = "Wedding's Dae - There's an uneasy feeling in this fort. Everyone's feeling real jumpy. Still, the weather is pretty bad today, and no one wants to venture out in a storm. Everyone agreed to stay an extra night here since we've got enough food. The cleric keeps swearing that they can hear scraping noises coming from the basement, though.";
	name = "adventurer diary fragment #2"
	},
/turf/open/floor/rogue/ruinedwood,
/area/rogue/outdoors/woods/churchfort/basement)
"nV" = (
/obj/effect/decal/cleanable/blood/tracks,
/turf/open/floor/rogue/blocks/bluestone,
/area/rogue/outdoors/woods/churchfort/basement)
"oi" = (
/turf/open/floor/rogue/dirt/road,
/area/rogue/outdoors/woods/churchfort/basement)
"oB" = (
/obj/structure/roguewindow,
/turf/open/floor/rogue/blocks/bluestone,
/area/rogue/outdoors/woods/churchfort/basement)
"pg" = (
/obj/structure/closet/crate/roguecloset/dark,
/obj/item/natural/cloth,
/obj/item/natural/cloth,
/obj/item/soap,
/obj/item/soap,
/obj/item/candle/yellow,
/obj/item/candle/yellow,
/obj/item/candle/yellow,
/obj/item/candle/yellow,
/obj/item/reagent_containers/powder/salt,
/obj/item/reagent_containers/powder/salt,
/obj/item/reagent_containers/powder/salt,
/obj/item/reagent_containers/powder/salt,
/obj/effect/decal/cleanable/cobweb{
	icon_state = "cobweb2"
	},
/turf/open/floor/rogue/ruinedwood,
/area/rogue/outdoors/woods/churchfort/basement)
"pr" = (
/mob/living/simple_animal/hostile/retaliate/rogue/orc/ranged,
/turf/open/floor/rogue/grass,
/area/rogue/outdoors/woods/churchfort/basement)
"pK" = (
/obj/structure/closet/crate/chest/crate,
/obj/item/reagent_containers/food/snacks/butter,
/obj/item/reagent_containers/food/snacks/butter,
/obj/item/reagent_containers/food/snacks/rogue/meat/poultry,
/obj/item/reagent_containers/food/snacks/rogue/meat/poultry,
/obj/item/reagent_containers/food/snacks/egg,
/obj/item/reagent_containers/food/snacks/egg,
/obj/item/reagent_containers/food/snacks/egg,
/obj/item/reagent_containers/food/snacks/egg,
/obj/item/reagent_containers/food/snacks/fat,
/obj/item/reagent_containers/food/snacks/fat,
/obj/item/reagent_containers/food/snacks/rogue/meat/steak,
/obj/item/reagent_containers/food/snacks/rogue/meat/steak,
/obj/item/reagent_containers/food/snacks/rogue/meat/steak,
/obj/item/reagent_containers/food/snacks/rogue/meat/steak,
/obj/item/reagent_containers/food/snacks/rogue/meat/steak,
/obj/item/reagent_containers/food/snacks/rogue/meat/steak,
/obj/effect/decal/cleanable/cobweb,
/turf/open/floor/rogue/blocks/green,
/area/rogue/outdoors/woods/churchfort/basement)
"sz" = (
/turf/open/floor/rogue/twig,
/area/rogue/outdoors/woods/churchfort/basement)
"sD" = (
/obj/item/chair/rogue,
/turf/open/floor/carpet/red,
/area/rogue/outdoors/woods/churchfort/basement)
"sR" = (
/obj/structure/table/wood{
	dir = 10;
	icon_state = "largetable"
	},
/turf/open/floor/carpet/red,
/area/rogue/outdoors/woods/churchfort/basement)
"sT" = (
/obj/structure/chair/wood/rogue{
	icon_state = "chair2";
	dir = 4
	},
/turf/open/floor/carpet/red,
/area/rogue/outdoors/woods/churchfort/basement)
"tu" = (
/obj/effect/decal/cleanable/blood/gibs,
/obj/effect/decal/cleanable/blood/tracks{
	dir = 4
	},
/obj/effect/decal/cleanable/blood,
/turf/open/floor/rogue/cobble,
/area/rogue/outdoors/woods/churchfort/basement)
"up" = (
/obj/structure/mineral_door/wood/donjon/stone{
	dir = 1;
	name = "Larder"
	},
/turf/open/floor/rogue/blocks/green,
/area/rogue/outdoors/woods/churchfort/basement)
"uB" = (
/obj/effect/decal/cleanable/blood/tracks{
	dir = 4
	},
/turf/open/floor/rogue/ruinedwood,
/area/rogue/outdoors/woods/churchfort/basement)
"vB" = (
/obj/effect/decal/cleanable/blood/tracks{
	dir = 6
	},
/obj/machinery/light/rogue/torchholder/r,
/turf/open/floor/rogue/twig,
/area/rogue/outdoors/woods/churchfort/basement)
"wL" = (
/obj/effect/decal/cleanable/blood/tracks,
/turf/open/floor/rogue/ruinedwood,
/area/rogue/outdoors/woods/churchfort/basement)
"xi" = (
/turf/open/floor/rogue/grass,
/area/rogue/outdoors/woods/churchfort/basement)
"zR" = (
/obj/structure/table/wood{
	dir = 9;
	icon_state = "largetable"
	},
/turf/open/floor/carpet/red,
/area/rogue/outdoors/woods/churchfort/basement)
"Aa" = (
/obj/effect/decal/cleanable/blood/gibs/down,
/obj/effect/decal/cleanable/blood,
/mob/living/simple_animal/hostile/retaliate/rogue/orc/ranged,
/turf/open/floor/rogue/cobble,
/area/rogue/outdoors/woods/churchfort/basement)
"BO" = (
/obj/structure/mineral_door/wood/donjon/stone{
	dir = 4;
	name = "North-East Tower"
	},
/obj/effect/decal/cleanable/blood/tracks{
	dir = 4
	},
/turf/open/floor/rogue/blocks/bluestone,
/area/rogue/outdoors/woods/churchfort/basement)
"CJ" = (
/turf/closed/mineral/random/rogue,
/area/rogue/outdoors/woods/churchfort/basement)
"CW" = (
/turf/closed/wall/mineral/rogue/stone,
/area/rogue/outdoors/woods/churchfort/basement)
"DM" = (
/obj/machinery/light/rogue/oven/south,
/turf/open/floor/rogue/tile/checkeralt,
/area/rogue/outdoors/woods/churchfort/basement)
"EB" = (
/obj/effect/decal/cleanable/blood/tracks,
/turf/open/floor/rogue/cobble,
/area/rogue/outdoors/woods/churchfort/basement)
"Fv" = (
/obj/structure/closet/crate/chest/wicker,
/obj/item/reagent_containers/food/snacks/rogue/crackerscooked,
/obj/item/reagent_containers/food/snacks/rogue/crackerscooked,
/obj/item/reagent_containers/food/snacks/rogue/crackerscooked,
/obj/item/reagent_containers/food/snacks/rogue/crackerscooked,
/obj/item/reagent_containers/food/snacks/rogue/crackerscooked,
/obj/item/reagent_containers/food/snacks/fat/salo,
/obj/item/reagent_containers/food/snacks/fat/salo,
/obj/item/reagent_containers/food/snacks/fat/salo,
/obj/item/reagent_containers/food/snacks/fat/salo,
/obj/item/reagent_containers/food/snacks/fat/salo,
/turf/open/floor/rogue/ruinedwood,
/area/rogue/outdoors/woods/churchfort/basement)
"FV" = (
/obj/structure/bars/passage{
	redstone_id = "church_keep_basement_gate";
	max_integrity = 9000
	},
/turf/open/floor/rogue/blocks/bluestone,
/area/rogue/outdoors/woods/churchfort/basement)
"Gz" = (
/obj/machinery/light/rogue/torchholder/c,
/turf/open/floor/rogue/cobble,
/area/rogue/outdoors/woods/churchfort/basement)
"GA" = (
/obj/structure/closet/crate/chest/wicker,
/obj/item/reagent_containers/food/snacks/rogue/meat/coppiette,
/obj/item/reagent_containers/food/snacks/rogue/meat/coppiette,
/obj/item/reagent_containers/food/snacks/rogue/meat/coppiette,
/obj/item/reagent_containers/food/snacks/rogue/meat/coppiette,
/obj/item/reagent_containers/food/snacks/rogue/meat/coppiette,
/obj/item/reagent_containers/food/snacks/rogue/saltfish,
/obj/item/reagent_containers/food/snacks/rogue/saltfish,
/obj/item/reagent_containers/food/snacks/rogue/saltfish,
/obj/item/reagent_containers/food/snacks/rogue/saltfish,
/obj/item/reagent_containers/food/snacks/rogue/saltfish,
/turf/open/floor/rogue/ruinedwood,
/area/rogue/outdoors/woods/churchfort/basement)
"GF" = (
/obj/machinery/light/rogue/torchholder/r,
/turf/open/floor/rogue/blocks/bluestone,
/area/rogue/outdoors/woods/churchfort/basement)
"IO" = (
/obj/effect/spawner/lootdrop/roguetown/alcohol/average,
/turf/open/floor/rogue/blocks/green,
/area/rogue/outdoors/woods/churchfort/basement)
"Jq" = (
/turf/closed/wall/mineral/rogue/stone/moss,
/area/rogue/outdoors/woods/churchfort/basement)
"JR" = (
/obj/machinery/light/rogue/torchholder/c,
/obj/structure/trap/skeleton,
/turf/open/floor/rogue/blocks/green,
/area/rogue/outdoors/woods/churchfort/basement)
"Kd" = (
/obj/item/roguebin/water,
/turf/open/floor/rogue/ruinedwood,
/area/rogue/outdoors/woods/churchfort/basement)
"Kq" = (
/obj/effect/decal/cleanable/blood/tracks{
	dir = 4
	},
/turf/open/floor/rogue/cobble,
/area/rogue/outdoors/woods/churchfort/basement)
"KC" = (
/turf/open/floor/rogue/ruinedwood,
/area/rogue/outdoors/woods/churchfort/basement)
"Mq" = (
/obj/structure/rack/rogue/shelf/big{
	icon_state = "shelf_biggest";
	pixel_y = 0
	},
/obj/item/reagent_containers/glass/cup/wooden{
	pixel_x = -9;
	pixel_y = 12
	},
/obj/item/reagent_containers/glass/cup/wooden{
	pixel_y = 12
	},
/obj/item/reagent_containers/glass/cup/wooden{
	pixel_x = 8;
	pixel_y = 12
	},
/obj/item/reagent_containers/glass/bowl{
	pixel_x = 6;
	pixel_y = -6
	},
/obj/item/reagent_containers/glass/bowl{
	pixel_x = -6;
	pixel_y = -6
	},
/obj/item/reagent_containers/glass/bowl{
	pixel_x = 6
	},
/obj/item/reagent_containers/glass/bowl{
	pixel_x = -6
	},
/turf/open/floor/rogue/tile/checkeralt,
/area/rogue/outdoors/woods/churchfort/basement)
"NJ" = (
/obj/item/chair/rogue{
	dir = 1
	},
/turf/open/floor/carpet/red,
/area/rogue/outdoors/woods/churchfort/basement)
"NQ" = (
/obj/machinery/light/rogue/wallfire{
	pixel_y = 32
	},
/turf/open/floor/rogue/ruinedwood,
/area/rogue/outdoors/woods/churchfort/basement)
"QQ" = (
/obj/machinery/light/rogue/torchholder/r,
/turf/open/floor/rogue/ruinedwood,
/area/rogue/outdoors/woods/churchfort/basement)
"QS" = (
/obj/structure/fermenting_barrel/water,
/obj/machinery/light/rogue/torchholder/l,
/turf/open/floor/rogue/ruinedwood,
/area/rogue/outdoors/woods/churchfort/basement)
"Rt" = (
/obj/structure/table/wood{
	dir = 5;
	icon_state = "largetable"
	},
/obj/item/chair/rogue{
	dir = 1
	},
/turf/open/floor/carpet/red,
/area/rogue/outdoors/woods/churchfort/basement)
"RN" = (
/mob/living/simple_animal/hostile/retaliate/rogue/orc/orc2,
/turf/open/floor/rogue/ruinedwood,
/area/rogue/outdoors/woods/churchfort/basement)
"RU" = (
/obj/structure/lever{
	name = "gate lever";
	redstone_id = "church_keep_courtyard_gate_2"
	},
/turf/open/floor/rogue/blocks/bluestone,
/area/rogue/outdoors/woods/churchfort/basement)
"SB" = (
/obj/structure/trap/spider,
/turf/open/floor/rogue/blocks/green,
/area/rogue/outdoors/woods/churchfort/basement)
"SV" = (
/obj/effect/decal/cleanable/blood/tracks{
	dir = 4
	},
/mob/living/simple_animal/hostile/retaliate/rogue/orc/orc2,
/turf/open/floor/rogue/cobble,
/area/rogue/outdoors/woods/churchfort/basement)
"SX" = (
/turf/open/floor/rogue/cobble,
/area/rogue/outdoors/woods/churchfort/basement)
"SY" = (
/obj/effect/decal/mossy{
	dir = 8
	},
/obj/effect/decal/mossy{
	dir = 1
	},
/turf/open/floor/rogue/dirt/road,
/area/rogue/outdoors/woods/churchfort/basement)
"Tl" = (
/obj/structure/well,
/turf/open/floor/rogue/grass,
/area/rogue/outdoors/woods/churchfort/basement)
"Uk" = (
/obj/structure/table/wood{
	dir = 6;
	icon_state = "largetable"
	},
/obj/item/chair/rogue,
/obj/machinery/light/rogue/torchholder/r,
/turf/open/floor/carpet/red,
/area/rogue/outdoors/woods/churchfort/basement)
"Us" = (
/obj/structure/table/wood{
	dir = 1;
	icon_state = "longtable"
	},
/obj/structure/fluff/millstone{
	pixel_y = 10;
	pixel_x = 4
	},
/turf/open/floor/rogue/tile/checkeralt,
/area/rogue/outdoors/woods/churchfort/basement)
"VZ" = (
/turf/open/floor/rogue/tile/checkeralt,
/area/rogue/outdoors/woods/churchfort/basement)
"WL" = (
/obj/item/reagent_containers/glass/bucket/wooden{
	pixel_x = 6;
	pixel_y = 10
	},
/turf/open/floor/rogue/grass,
/area/rogue/outdoors/woods/churchfort/basement)
"Xf" = (
/mob/living/carbon/human/species/goblin/npc/ambush/cave,
/turf/open/floor/rogue/tile/checkeralt,
/area/rogue/outdoors/woods/churchfort/basement)
"XB" = (
/turf/open/floor/rogue/blocks/green,
/area/rogue/outdoors/woods/churchfort/basement)
"Yd" = (
/obj/structure/table/wood{
	icon_state = "longtable"
	},
/obj/item/kitchen/rollingpin,
/obj/item/rogueweapon/huntingknife/chefknife,
/turf/open/floor/rogue/tile/checkeralt,
/area/rogue/outdoors/woods/churchfort/basement)
"Yr" = (
/obj/structure/closet/crate/roguecloset/dark,
/obj/item/natural/cloth,
/obj/item/natural/cloth,
/obj/item/natural/cloth,
/obj/item/natural/cloth,
/obj/item/flashlight/flare/torch/metal,
/obj/item/flashlight/flare/torch/metal,
/obj/item/candle/yellow,
/obj/item/candle/yellow,
/obj/effect/decal/cleanable/cobweb,
/turf/open/floor/rogue/twig,
/area/rogue/outdoors/woods/churchfort/basement)
"YF" = (
/turf/closed/wall/mineral/rogue/stone/red_moss,
/area/rogue/outdoors/woods/churchfort/basement)
"YG" = (
/obj/structure/bars/passage{
	redstone_id = "church_keep_courtyard_gate_2";
	max_integrity = 9000
	},
/turf/open/floor/rogue/blocks/bluestone,
/area/rogue/outdoors/woods/churchfort/basement)
"YJ" = (
/mob/living/simple_animal/hostile/retaliate/rogue/orc/spear2,
/turf/open/floor/rogue/blocks/bluestone,
/area/rogue/outdoors/woods/churchfort/basement)
"YO" = (
/mob/living/simple_animal/hostile/retaliate/rogue/orc/ranged,
/turf/open/floor/rogue/ruinedwood,
/area/rogue/outdoors/woods/churchfort/basement)

(1,1,1) = {"
CJ
CJ
CJ
CW
dI
iV
FV
YJ
tu
Aa
YG
oi
oi
pr
oi
"}
(2,1,1) = {"
CJ
CJ
CJ
CW
YF
CW
YF
Gz
SV
RU
Jq
xi
xi
xi
xi
"}
(3,1,1) = {"
CJ
CJ
CJ
CJ
CJ
CJ
Jq
ec
Kq
lk
kn
xi
Tl
WL
xi
"}
(4,1,1) = {"
CJ
CJ
CJ
CJ
CJ
CJ
Jq
SX
ac
lk
CW
xi
xi
xi
iu
"}
(5,1,1) = {"
CJ
CJ
CJ
CJ
CW
Jq
Jq
oB
BO
oB
Jq
Jq
CW
dB
SY
"}
(6,1,1) = {"
CJ
CJ
CJ
CJ
CW
al
hD
Mq
uB
lK
QS
Kd
CW
Jq
kn
"}
(7,1,1) = {"
CJ
CJ
CJ
CJ
CW
DM
VZ
VZ
kU
dk
gG
KC
oB
SX
SX
"}
(8,1,1) = {"
CJ
CJ
CJ
CJ
CW
Yd
VZ
Xf
KC
kU
wL
wL
iD
nV
EB
"}
(9,1,1) = {"
CJ
CJ
CJ
CJ
CW
Us
VZ
KC
KC
KC
KC
KC
oB
hA
GF
"}
(10,1,1) = {"
CW
Jq
Jq
CW
CW
CW
CW
NQ
KC
RN
nq
KC
CW
CW
Jq
"}
(11,1,1) = {"
CW
pK
cT
IO
CW
Fv
GA
KC
cS
sT
sD
lC
CW
Yr
sz
"}
(12,1,1) = {"
Jq
JR
SB
XB
up
KC
KC
YO
cS
zR
sR
NJ
Jq
cK
vB
"}
(13,1,1) = {"
CW
fv
if
bw
Jq
pg
QQ
KC
NJ
Rt
Uk
cS
CW
CW
CW
"}
(14,1,1) = {"
CW
CW
Jq
Jq
Jq
Jq
Jq
CW
CW
Jq
Jq
CW
CW
CJ
CJ
"}
(15,1,1) = {"
CJ
CJ
CJ
CJ
CJ
CJ
CJ
CJ
CJ
CJ
CJ
CJ
CJ
CJ
CJ
"}
