//MAP CONVERTED BY dmm2tgm.py THIS HEADER COMMENT PREVENTS RECONVERSION, DO NOT REMOVE
"aw" = (
/turf/open/floor/rogue/dirt/road,
/area/rogue/outdoors/woods/churchfort/basement)
"bO" = (
/obj/effect/decal/cleanable/blood/gibs,
/obj/effect/decal/cleanable/blood/tracks{
	dir = 4
	},
/obj/effect/decal/cleanable/blood,
/turf/open/floor/rogue/cobble,
/area/rogue/outdoors/woods/churchfort/basement)
"dr" = (
/turf/open/transparent/openspace,
/area/rogue/outdoors/woods/churchfort/basement)
"dY" = (
/turf/open/floor/rogue/grass,
/area/rogue/outdoors/woods/churchfort/basement)
"eC" = (
/obj/structure/bars/grille{
	max_integrity = 5000;
	density = 1
	},
/turf/open/floor/rogue/blocks/bluestone,
/area/rogue/outdoors/woods/churchfort/basement)
"fx" = (
/obj/machinery/light/rogue/wallfire{
	pixel_y = 32
	},
/turf/open/floor/rogue/ruinedwood,
/area/rogue/outdoors/woods/churchfort/basement)
"fR" = (
/obj/structure/lever{
	name = "gate lever";
	redstone_id = "church_keep_courtyard_gate_2"
	},
/turf/open/floor/rogue/blocks/bluestone,
/area/rogue/outdoors/woods/churchfort/basement)
"gd" = (
/obj/structure/closet/crate/chest/crate,
/obj/item/reagent_containers/food/snacks/grown/wheat,
/obj/item/reagent_containers/food/snacks/grown/wheat,
/obj/item/reagent_containers/food/snacks/grown/wheat,
/obj/item/reagent_containers/food/snacks/grown/wheat,
/obj/item/reagent_containers/food/snacks/grown/wheat,
/obj/item/reagent_containers/food/snacks/grown/wheat,
/obj/item/reagent_containers/food/snacks/grown/oat,
/obj/item/reagent_containers/food/snacks/grown/oat,
/obj/item/reagent_containers/food/snacks/grown/oat,
/obj/item/reagent_containers/food/snacks/grown/oat,
/obj/item/reagent_containers/food/snacks/grown/oat,
/obj/item/reagent_containers/food/snacks/grown/oat,
/turf/open/floor/rogue/blocks/green,
/area/rogue/outdoors/woods/churchfort/basement)
"gV" = (
/obj/structure/bars/passage{
	redstone_id = "church_keep_courtyard_gate_2";
	max_integrity = 9000
	},
/turf/open/floor/rogue/blocks/bluestone,
/area/rogue/outdoors/woods/churchfort/basement)
"hd" = (
/obj/effect/decal/mossy{
	dir = 4
	},
/turf/open/floor/rogue/grass,
/area/rogue/outdoors/woods/churchfort/basement)
"hB" = (
/obj/structure/stairs/stone,
/turf/open/floor/rogue/blocks/bluestone,
/area/rogue/outdoors/woods/churchfort/basement)
"ip" = (
/obj/effect/decal/cleanable/blood/tracks{
	dir = 4
	},
/turf/open/floor/rogue/blocks/bluestone,
/area/rogue/outdoors/woods/churchfort/basement)
"iF" = (
/obj/effect/decal/cleanable/blood/tracks,
/turf/open/floor/rogue/ruinedwood,
/area/rogue/outdoors/woods/churchfort/basement)
"jf" = (
/turf/closed/mineral/random/rogue,
/area/rogue/outdoors/woods/churchfort/basement)
"ji" = (
/obj/structure/table/wood{
	icon_state = "longtable"
	},
/obj/item/kitchen/rollingpin,
/obj/item/rogueweapon/huntingknife/chefknife,
/turf/open/floor/rogue/tile/checkeralt,
/area/rogue/outdoors/woods/churchfort/basement)
"jL" = (
/obj/structure/table/wood{
	dir = 5;
	icon_state = "largetable"
	},
/obj/item/chair/rogue{
	dir = 1
	},
/turf/open/floor/carpet/red,
/area/rogue/outdoors/woods/churchfort/basement)
"kv" = (
/turf/open/floor/rogue/twig,
/area/rogue/outdoors/woods/churchfort/basement)
"kz" = (
/obj/structure/roguewindow,
/turf/open/floor/rogue/blocks/bluestone,
/area/rogue/outdoors/woods/churchfort/basement)
"kZ" = (
/turf/open/floor/rogue/tile/checkeralt,
/area/rogue/outdoors/woods/churchfort/basement)
"ma" = (
/mob/living/simple_animal/hostile/retaliate/rogue/orc/ranged,
/turf/open/floor/rogue/grass,
/area/rogue/outdoors/woods/churchfort/basement)
"mz" = (
/obj/effect/decal/mossy{
	dir = 8
	},
/obj/effect/decal/mossy{
	dir = 1
	},
/turf/open/floor/rogue/dirt/road,
/area/rogue/outdoors/woods/churchfort/basement)
"mT" = (
/obj/effect/decal/cleanable/blood/gibs/down,
/obj/effect/decal/cleanable/blood,
/mob/living/simple_animal/hostile/retaliate/rogue/orc/ranged,
/turf/open/floor/rogue/cobble,
/area/rogue/outdoors/woods/churchfort/basement)
"nt" = (
/obj/structure/closet/crate/chest/crate,
/obj/item/reagent_containers/food/snacks/grown/onion/rogue,
/obj/item/reagent_containers/food/snacks/grown/onion/rogue,
/obj/item/reagent_containers/food/snacks/grown/onion/rogue,
/obj/item/reagent_containers/food/snacks/grown/onion/rogue,
/obj/item/reagent_containers/food/snacks/grown/cabbage/rogue,
/obj/item/reagent_containers/food/snacks/grown/cabbage/rogue,
/obj/item/reagent_containers/food/snacks/grown/cabbage/rogue,
/obj/item/reagent_containers/food/snacks/grown/cabbage/rogue,
/obj/item/reagent_containers/food/snacks/grown/potato/rogue,
/obj/item/reagent_containers/food/snacks/grown/potato/rogue,
/obj/item/reagent_containers/food/snacks/grown/potato/rogue,
/obj/item/reagent_containers/food/snacks/grown/potato/rogue,
/obj/item/reagent_containers/food/snacks/grown/berries/rogue,
/obj/item/reagent_containers/food/snacks/grown/berries/rogue,
/obj/item/reagent_containers/food/snacks/grown/berries/rogue,
/obj/item/reagent_containers/food/snacks/grown/berries/rogue,
/obj/effect/decal/cleanable/cobweb{
	icon_state = "cobweb2"
	},
/turf/open/floor/rogue/blocks/green,
/area/rogue/outdoors/woods/churchfort/basement)
"pI" = (
/obj/effect/decal/mossy,
/turf/open/floor/rogue/grass,
/area/rogue/outdoors/woods/churchfort/basement)
"pZ" = (
/obj/structure/closet/crate/roguecloset/dark,
/obj/item/natural/cloth,
/obj/item/natural/cloth,
/obj/item/natural/cloth,
/obj/item/natural/cloth,
/obj/item/flashlight/flare/torch/metal,
/obj/item/flashlight/flare/torch/metal,
/obj/item/candle/yellow,
/obj/item/candle/yellow,
/obj/effect/decal/cleanable/cobweb,
/turf/open/floor/rogue/twig,
/area/rogue/outdoors/woods/churchfort/basement)
"qh" = (
/obj/structure/closet/crate/chest/crate,
/obj/item/reagent_containers/food/snacks/butter,
/obj/item/reagent_containers/food/snacks/butter,
/obj/item/reagent_containers/food/snacks/rogue/meat/poultry,
/obj/item/reagent_containers/food/snacks/rogue/meat/poultry,
/obj/item/reagent_containers/food/snacks/egg,
/obj/item/reagent_containers/food/snacks/egg,
/obj/item/reagent_containers/food/snacks/egg,
/obj/item/reagent_containers/food/snacks/egg,
/obj/item/reagent_containers/food/snacks/fat,
/obj/item/reagent_containers/food/snacks/fat,
/obj/item/reagent_containers/food/snacks/rogue/meat/steak,
/obj/item/reagent_containers/food/snacks/rogue/meat/steak,
/obj/item/reagent_containers/food/snacks/rogue/meat/steak,
/obj/item/reagent_containers/food/snacks/rogue/meat/steak,
/obj/item/reagent_containers/food/snacks/rogue/meat/steak,
/obj/item/reagent_containers/food/snacks/rogue/meat/steak,
/obj/effect/decal/cleanable/cobweb,
/turf/open/floor/rogue/blocks/green,
/area/rogue/outdoors/woods/churchfort/basement)
"rX" = (
/turf/open/floor/rogue/blocks/bluestone,
/area/rogue/outdoors/woods/churchfort/basement)
"tj" = (
/mob/living/carbon/human/species/goblin/npc/ambush/cave,
/turf/open/floor/rogue/tile/checkeralt,
/area/rogue/outdoors/woods/churchfort/basement)
"tr" = (
/obj/structure/table/wood{
	dir = 1;
	icon_state = "longtable"
	},
/obj/structure/fluff/millstone{
	pixel_y = 10;
	pixel_x = 4
	},
/turf/open/floor/rogue/tile/checkeralt,
/area/rogue/outdoors/woods/churchfort/basement)
"uO" = (
/obj/structure/rack/rogue/shelf/big{
	icon_state = "shelf_biggest";
	pixel_y = 0
	},
/obj/item/reagent_containers/glass/cup/wooden{
	pixel_x = -9;
	pixel_y = 12
	},
/obj/item/reagent_containers/glass/cup/wooden{
	pixel_y = 12
	},
/obj/item/reagent_containers/glass/cup/wooden{
	pixel_x = 8;
	pixel_y = 12
	},
/obj/item/reagent_containers/glass/bowl{
	pixel_x = 6;
	pixel_y = -6
	},
/obj/item/reagent_containers/glass/bowl{
	pixel_x = -6;
	pixel_y = -6
	},
/obj/item/reagent_containers/glass/bowl{
	pixel_x = 6
	},
/obj/item/reagent_containers/glass/bowl{
	pixel_x = -6
	},
/turf/open/floor/rogue/tile/checkeralt,
/area/rogue/outdoors/woods/churchfort/basement)
"uP" = (
/obj/machinery/light/rogue/torchholder/r,
/turf/open/floor/rogue/blocks/bluestone,
/area/rogue/outdoors/woods/churchfort/basement)
"uT" = (
/obj/effect/decal/cleanable/cobweb{
	icon_state = "cobweb2"
	},
/turf/open/floor/rogue/blocks/bluestone,
/area/rogue/outdoors/woods/churchfort/basement)
"vL" = (
/obj/structure/closet/crate/chest/wicker,
/obj/item/reagent_containers/food/snacks/rogue/crackerscooked,
/obj/item/reagent_containers/food/snacks/rogue/crackerscooked,
/obj/item/reagent_containers/food/snacks/rogue/crackerscooked,
/obj/item/reagent_containers/food/snacks/rogue/crackerscooked,
/obj/item/reagent_containers/food/snacks/rogue/crackerscooked,
/obj/item/reagent_containers/food/snacks/fat/salo,
/obj/item/reagent_containers/food/snacks/fat/salo,
/obj/item/reagent_containers/food/snacks/fat/salo,
/obj/item/reagent_containers/food/snacks/fat/salo,
/obj/item/reagent_containers/food/snacks/fat/salo,
/turf/open/floor/rogue/ruinedwood,
/area/rogue/outdoors/woods/churchfort/basement)
"wI" = (
/turf/open/floor/rogue/cobble,
/area/rogue/outdoors/woods/churchfort/basement)
"xw" = (
/obj/machinery/light/rogue/torchholder/c,
/turf/open/floor/rogue/cobble,
/area/rogue/outdoors/woods/churchfort/basement)
"xA" = (
/obj/machinery/light/rogue/hearth,
/obj/item/cooking/pan,
/obj/effect/decal/cleanable/cobweb,
/turf/open/floor/rogue/tile/checkeralt,
/area/rogue/outdoors/woods/churchfort/basement)
"xM" = (
/obj/effect/decal/cleanable/blood/tracks{
	dir = 5
	},
/turf/open/floor/rogue/ruinedwood,
/area/rogue/outdoors/woods/churchfort/basement)
"xQ" = (
/obj/effect/decal/cleanable/blood/tracks,
/turf/open/floor/rogue/cobble,
/area/rogue/outdoors/woods/churchfort/basement)
"yC" = (
/mob/living/carbon/human/species/goblin/npc/ambush/cave,
/turf/open/floor/rogue/ruinedwood,
/area/rogue/outdoors/woods/churchfort/basement)
"yF" = (
/obj/effect/decal/cleanable/blood/tracks{
	dir = 10
	},
/turf/open/floor/rogue/ruinedwood,
/area/rogue/outdoors/woods/churchfort/basement)
"Bm" = (
/obj/structure/fermenting_barrel/blessedwine,
/turf/open/floor/rogue/blocks/green,
/area/rogue/outdoors/woods/churchfort/basement)
"CW" = (
/turf/closed/wall/mineral/rogue/stone/moss,
/area/rogue/outdoors/woods/churchfort/basement)
"Ej" = (
/turf/closed/wall/mineral/rogue/stone,
/area/rogue/outdoors/woods/churchfort/basement)
"EK" = (
/turf/closed/wall/mineral/rogue/stone/red_moss,
/area/rogue/outdoors/woods/churchfort/basement)
"Ga" = (
/obj/item/chair/rogue{
	dir = 1
	},
/turf/open/floor/carpet/red,
/area/rogue/outdoors/woods/churchfort/basement)
"GN" = (
/obj/effect/decal/cleanable/blood/tracks{
	dir = 4
	},
/turf/open/floor/rogue/ruinedwood,
/area/rogue/outdoors/woods/churchfort/basement)
"GV" = (
/obj/machinery/light/rogue/hearth,
/obj/item/reagent_containers/glass/bucket/pot,
/obj/machinery/light/rogue/torchholder/l,
/turf/open/floor/rogue/tile/checkeralt,
/area/rogue/outdoors/woods/churchfort/basement)
"Hk" = (
/obj/structure/mineral_door/wood/donjon/stone{
	dir = 1;
	name = "Larder"
	},
/turf/open/floor/rogue/blocks/green,
/area/rogue/outdoors/woods/churchfort/basement)
"In" = (
/obj/structure/fluff/walldeco/katholikos_banner{
	pixel_y = 25
	},
/turf/open/floor/rogue/blocks/bluestone,
/area/rogue/outdoors/woods/churchfort/basement)
"IV" = (
/obj/effect/decal/cleanable/blood/tracks{
	dir = 4
	},
/mob/living/simple_animal/hostile/retaliate/rogue/orc/orc2,
/turf/open/floor/rogue/cobble,
/area/rogue/outdoors/woods/churchfort/basement)
"Jv" = (
/obj/structure/bars/passage{
	redstone_id = "church_keep_basement_gate";
	max_integrity = 9000
	},
/turf/open/floor/rogue/blocks/bluestone,
/area/rogue/outdoors/woods/churchfort/basement)
"Jx" = (
/mob/living/simple_animal/hostile/retaliate/rogue/orc/spear2,
/turf/open/floor/rogue/blocks/bluestone,
/area/rogue/outdoors/woods/churchfort/basement)
"JJ" = (
/obj/effect/spawner/lootdrop/roguetown/alcohol/average,
/turf/open/floor/rogue/blocks/green,
/area/rogue/outdoors/woods/churchfort/basement)
"JK" = (
/obj/structure/chair/wood/rogue{
	icon_state = "chair2";
	dir = 4
	},
/turf/open/floor/carpet/red,
/area/rogue/outdoors/woods/churchfort/basement)
"Ki" = (
/obj/structure/bed/rogue/inn/hay,
/obj/item/bedsheet/rogue/pelt,
/obj/effect/decal/cleanable/blood,
/turf/open/floor/rogue/twig,
/area/rogue/outdoors/woods/churchfort/basement)
"KC" = (
/obj/item/paper{
	info = "Wedding's Dae - There's an uneasy feeling in this fort. Everyone's feeling real jumpy. Still, the weather is pretty bad today, and no one wants to venture out in a storm. Everyone agreed to stay an extra night here since we've got enough food. The cleric keeps swearing that they can hear scraping noises coming from the basement, though.";
	name = "adventurer diary fragment #2"
	},
/turf/open/floor/rogue/ruinedwood,
/area/rogue/outdoors/woods/churchfort/basement)
"KN" = (
/obj/machinery/light/rogue/torchholder/c,
/turf/open/floor/rogue/blocks/green,
/area/rogue/outdoors/woods/churchfort/basement)
"Ll" = (
/obj/structure/well,
/turf/open/floor/rogue/grass,
/area/rogue/outdoors/woods/churchfort/basement)
"LV" = (
/obj/structure/table/wood{
	dir = 6;
	icon_state = "largetable"
	},
/obj/item/chair/rogue,
/obj/machinery/light/rogue/torchholder/r,
/turf/open/floor/carpet/red,
/area/rogue/outdoors/woods/churchfort/basement)
"LY" = (
/obj/structure/closet/crate/roguecloset/dark,
/obj/item/natural/cloth,
/obj/item/natural/cloth,
/obj/item/soap,
/obj/item/soap,
/obj/item/candle/yellow,
/obj/item/candle/yellow,
/obj/item/candle/yellow,
/obj/item/candle/yellow,
/obj/item/reagent_containers/powder/salt,
/obj/item/reagent_containers/powder/salt,
/obj/item/reagent_containers/powder/salt,
/obj/item/reagent_containers/powder/salt,
/obj/effect/decal/cleanable/cobweb{
	icon_state = "cobweb2"
	},
/turf/open/floor/rogue/ruinedwood,
/area/rogue/outdoors/woods/churchfort/basement)
"Mb" = (
/obj/effect/spawner/lootdrop/roguetown/alcohol/cheap,
/turf/open/floor/rogue/ruinedwood,
/area/rogue/outdoors/woods/churchfort/basement)
"Mp" = (
/obj/structure/fermenting_barrel/water,
/obj/machinery/light/rogue/torchholder/l,
/turf/open/floor/rogue/ruinedwood,
/area/rogue/outdoors/woods/churchfort/basement)
"OP" = (
/obj/machinery/light/rogue/oven/south,
/turf/open/floor/rogue/tile/checkeralt,
/area/rogue/outdoors/woods/churchfort/basement)
"Pa" = (
/obj/machinery/light/rogue/torchholder/r,
/turf/open/floor/rogue/ruinedwood,
/area/rogue/outdoors/woods/churchfort/basement)
"Ph" = (
/obj/structure/table/wood{
	dir = 9;
	icon_state = "largetable"
	},
/turf/open/floor/carpet/red,
/area/rogue/outdoors/woods/churchfort/basement)
"Qn" = (
/mob/living/carbon/human/species/goblin/npc/ambush/cave,
/turf/open/floor/carpet/red,
/area/rogue/outdoors/woods/churchfort/basement)
"Qp" = (
/obj/effect/decal/cleanable/blood/tracks{
	dir = 6
	},
/obj/machinery/light/rogue/torchholder/r,
/turf/open/floor/rogue/twig,
/area/rogue/outdoors/woods/churchfort/basement)
"QJ" = (
/obj/effect/decal/cleanable/blood/tracks,
/turf/open/floor/rogue/blocks/bluestone,
/area/rogue/outdoors/woods/churchfort/basement)
"TF" = (
/obj/structure/closet/crate/chest/wicker,
/obj/item/reagent_containers/food/snacks/rogue/meat/coppiette,
/obj/item/reagent_containers/food/snacks/rogue/meat/coppiette,
/obj/item/reagent_containers/food/snacks/rogue/meat/coppiette,
/obj/item/reagent_containers/food/snacks/rogue/meat/coppiette,
/obj/item/reagent_containers/food/snacks/rogue/meat/coppiette,
/obj/item/reagent_containers/food/snacks/rogue/saltfish,
/obj/item/reagent_containers/food/snacks/rogue/saltfish,
/obj/item/reagent_containers/food/snacks/rogue/saltfish,
/obj/item/reagent_containers/food/snacks/rogue/saltfish,
/obj/item/reagent_containers/food/snacks/rogue/saltfish,
/turf/open/floor/rogue/ruinedwood,
/area/rogue/outdoors/woods/churchfort/basement)
"UE" = (
/obj/effect/decal/cleanable/blood/tracks{
	dir = 4
	},
/turf/open/floor/rogue/cobble,
/area/rogue/outdoors/woods/churchfort/basement)
"Vf" = (
/turf/open/floor/rogue/ruinedwood,
/area/rogue/outdoors/woods/churchfort/basement)
"VE" = (
/obj/structure/table/wood{
	dir = 10;
	icon_state = "largetable"
	},
/turf/open/floor/carpet/red,
/area/rogue/outdoors/woods/churchfort/basement)
"WH" = (
/obj/item/roguebin/water,
/turf/open/floor/rogue/ruinedwood,
/area/rogue/outdoors/woods/churchfort/basement)
"WJ" = (
/obj/item/chair/rogue,
/turf/open/floor/carpet/red,
/area/rogue/outdoors/woods/churchfort/basement)
"Yy" = (
/turf/open/floor/rogue/blocks/green,
/area/rogue/outdoors/woods/churchfort/basement)
"YB" = (
/obj/structure/mineral_door/wood/donjon/stone{
	dir = 1;
	name = "North-East Tower"
	},
/obj/effect/decal/cleanable/blood/tracks,
/turf/open/floor/rogue/ruinedwood,
/area/rogue/outdoors/woods/churchfort/basement)
"YO" = (
/obj/structure/mineral_door/wood/donjon/stone{
	dir = 4;
	name = "North-East Tower"
	},
/obj/effect/decal/cleanable/blood/tracks{
	dir = 4
	},
/turf/open/floor/rogue/blocks/bluestone,
/area/rogue/outdoors/woods/churchfort/basement)
"Zc" = (
/turf/open/floor/carpet/red,
/area/rogue/outdoors/woods/churchfort/basement)
"ZD" = (
/obj/item/reagent_containers/glass/bucket/wooden{
	pixel_x = 6;
	pixel_y = 10
	},
/turf/open/floor/rogue/grass,
/area/rogue/outdoors/woods/churchfort/basement)
"ZX" = (
/obj/effect/spawner/lootdrop/roguetown/alcohol/expensive,
/turf/open/floor/rogue/blocks/green,
/area/rogue/outdoors/woods/churchfort/basement)

(1,1,1) = {"
jf
jf
jf
Ej
dr
hB
Jv
Jx
bO
mT
gV
aw
aw
ma
aw
"}
(2,1,1) = {"
jf
jf
jf
Ej
EK
Ej
EK
xw
IV
fR
CW
dY
dY
dY
dY
"}
(3,1,1) = {"
jf
jf
jf
jf
jf
jf
CW
In
UE
rX
eC
dY
Ll
ZD
dY
"}
(4,1,1) = {"
jf
jf
jf
jf
jf
jf
CW
wI
ip
rX
Ej
dY
dY
dY
hd
"}
(5,1,1) = {"
jf
jf
jf
jf
Ej
CW
CW
kz
YO
kz
CW
CW
Ej
pI
mz
"}
(6,1,1) = {"
jf
jf
jf
jf
Ej
xA
GV
uO
GN
Mb
Mp
WH
Ej
CW
eC
"}
(7,1,1) = {"
jf
jf
jf
jf
Ej
OP
kZ
kZ
xM
yF
yC
Vf
kz
wI
wI
"}
(8,1,1) = {"
jf
jf
jf
jf
Ej
ji
kZ
tj
Vf
xM
iF
iF
YB
QJ
xQ
"}
(9,1,1) = {"
jf
jf
jf
jf
Ej
tr
kZ
Vf
Vf
Vf
Vf
Vf
kz
uT
uP
"}
(10,1,1) = {"
Ej
CW
CW
Ej
Ej
Ej
Ej
fx
Vf
yC
KC
Vf
Ej
Ej
CW
"}
(11,1,1) = {"
Ej
qh
ZX
JJ
Ej
vL
TF
Vf
Zc
JK
WJ
Qn
Ej
pZ
kv
"}
(12,1,1) = {"
CW
KN
Yy
Yy
Hk
Vf
Vf
yC
Zc
Ph
VE
Ga
CW
Ki
Qp
"}
(13,1,1) = {"
Ej
nt
gd
Bm
CW
LY
Pa
Vf
Ga
jL
LV
Zc
Ej
Ej
Ej
"}
(14,1,1) = {"
Ej
Ej
CW
CW
CW
CW
CW
Ej
Ej
CW
CW
Ej
Ej
jf
jf
"}
(15,1,1) = {"
jf
jf
jf
jf
jf
jf
jf
jf
jf
jf
jf
jf
jf
jf
jf
"}
