//MAP CONVERTED BY dmm2tgm.py THIS HEADER COMMENT PREVENTS RECONVERSION, DO NOT REMOVE
"an" = (
/obj/structure/trap/spider,
/turf/open/floor/rogue/cobble,
/area/rogue/outdoors/woods/churchfort/basement)
"as" = (
/obj/machinery/light/rogue/torchholder/r,
/turf/open/floor/rogue/blocks/green,
/area/rogue/outdoors/woods/churchfort/basement)
"by" = (
/obj/machinery/loom,
/turf/open/floor/rogue/ruinedwood/turned,
/area/rogue/outdoors/woods/churchfort/basement)
"cf" = (
/turf/closed/wall/mineral/rogue/stone/moss,
/area/rogue/outdoors/woods/churchfort/basement)
"cz" = (
/obj/structure/fluff/walldeco/katholikos_banner{
	pixel_y = 25
	},
/turf/open/transparent/openspace,
/area/rogue/outdoors/woods/churchfort/basement)
"cA" = (
/obj/structure/fluff/dryingrack,
/obj/machinery/light/rogue/torchholder/l,
/turf/open/floor/rogue/ruinedwood/turned,
/area/rogue/outdoors/woods/churchfort/basement)
"dd" = (
/turf/open/floor/rogue/blocks/green,
/area/rogue/outdoors/woods/churchfort/basement)
"eh" = (
/obj/structure/mineral_door/wood/donjon/stone{
	name = "Alchemy";
	dir = 4
	},
/turf/open/floor/rogue/ruinedwood/turned,
/area/rogue/outdoors/woods/churchfort/basement)
"eO" = (
/obj/structure/curtain/bounty{
	color = "grey"
	},
/turf/open/floor/rogue/tile/checkeralt,
/area/rogue/outdoors/woods/churchfort/basement)
"fo" = (
/obj/structure/closet/crate/chest/crate,
/obj/item/reagent_containers/food/snacks/grown/rogue/sweetleaf,
/obj/item/reagent_containers/food/snacks/grown/rogue/sweetleaf,
/obj/item/reagent_containers/food/snacks/grown/rogue/sweetleaf,
/obj/item/reagent_containers/food/snacks/grown/rogue/sweetleaf,
/obj/item/reagent_containers/food/snacks/grown/rogue/sweetleaf,
/obj/item/reagent_containers/food/snacks/grown/rogue/pipeweed,
/obj/item/reagent_containers/food/snacks/grown/rogue/pipeweed,
/obj/item/reagent_containers/food/snacks/grown/rogue/pipeweed,
/obj/item/reagent_containers/food/snacks/grown/rogue/pipeweed,
/obj/item/reagent_containers/food/snacks/grown/rogue/pipeweed,
/obj/item/reagent_containers/food/snacks/grown/rogue/fyritius,
/obj/item/reagent_containers/food/snacks/grown/rogue/fyritius,
/obj/item/reagent_containers/food/snacks/grown/rogue/fyritius,
/obj/item/reagent_containers/food/snacks/grown/rogue/fyritius,
/obj/item/reagent_containers/food/snacks/grown/rogue/fyritius,
/turf/open/floor/rogue/blocks/green,
/area/rogue/outdoors/woods/churchfort/basement)
"fz" = (
/obj/structure/mineral_door/wood/donjon/stone{
	name = "Infirmary"
	},
/turf/open/floor/rogue/ruinedwood/turned,
/area/rogue/outdoors/woods/churchfort/basement)
"fT" = (
/obj/machinery/light/rogue/torchholder/r,
/turf/open/floor/rogue/ruinedwood/turned,
/area/rogue/outdoors/woods/churchfort/basement)
"gH" = (
/obj/effect/decal/cleanable/blood/tracks{
	dir = 5
	},
/turf/open/floor/rogue/blocks/green,
/area/rogue/outdoors/woods/churchfort/basement)
"ji" = (
/obj/structure/fluff/alch,
/turf/open/floor/rogue/tile/checkeralt,
/area/rogue/outdoors/woods/churchfort/basement)
"kD" = (
/obj/structure/roguewindow,
/turf/open/floor/rogue/blocks/bluestone,
/area/rogue/outdoors/woods/churchfort/basement)
"la" = (
/obj/structure/roguewindow/openclose{
	icon_state = "woodwindowdir";
	dir = 4
	},
/turf/open/floor/rogue/blocks/bluestone,
/area/rogue/outdoors/woods/churchfort/basement)
"oA" = (
/obj/structure/fluff/littlebanners/elemental,
/turf/open/transparent/openspace,
/area/rogue/outdoors/woods/churchfort/basement)
"oO" = (
/obj/effect/decal/cleanable/cobweb{
	icon_state = "cobweb2"
	},
/turf/open/floor/rogue/blocks/green,
/area/rogue/outdoors/woods/churchfort/basement)
"oU" = (
/obj/structure/fluff/railing/border{
	dir = 4
	},
/obj/structure/fluff/railing/border{
	dir = 8;
	icon_state = "border"
	},
/obj/structure/fluff/railing/border,
/turf/open/transparent/openspace,
/area/rogue/outdoors/woods/churchfort/basement)
"pU" = (
/turf/open/floor/rogue/grassyel,
/area/rogue/outdoors/woods/churchfort/basement)
"qY" = (
/obj/structure/closet/crate/chest/crate,
/obj/item/natural/hide,
/obj/item/natural/hide,
/obj/item/natural/hide,
/obj/item/natural/hide,
/obj/item/natural/hide,
/obj/item/natural/hide,
/obj/item/natural/hide,
/obj/item/natural/hide,
/obj/item/natural/hide,
/obj/item/natural/hide,
/obj/item/natural/hide,
/obj/item/natural/hide,
/obj/item/natural/hide,
/obj/item/natural/hide,
/turf/open/floor/rogue/ruinedwood/turned,
/area/rogue/outdoors/woods/churchfort/basement)
"rl" = (
/obj/structure/closet/crate/chest/crate,
/obj/item/natural/bundle/fibers/full{
	pixel_x = -5
	},
/obj/item/natural/bundle/fibers/full,
/obj/item/natural/bundle/fibers/full{
	pixel_x = 5
	},
/obj/item/natural/bundle/fibers/full{
	pixel_x = -5
	},
/obj/item/natural/bundle/fibers/full,
/obj/item/natural/bundle/fibers/full{
	pixel_x = 5
	},
/turf/open/floor/rogue/ruinedwood/turned,
/area/rogue/outdoors/woods/churchfort/basement)
"ro" = (
/obj/structure/bed/rogue/inn/hay,
/obj/structure/curtain/bounty{
	color = "grey"
	},
/turf/open/floor/rogue/blocks/green,
/area/rogue/outdoors/woods/churchfort/basement)
"rt" = (
/obj/structure/fluff/dryingrack,
/turf/open/floor/rogue/cobble,
/area/rogue/outdoors/woods/churchfort/basement)
"rZ" = (
/turf/open/floor/rogue/blocks,
/area/rogue/outdoors/woods/churchfort/basement)
"tB" = (
/obj/effect/decal/cleanable/blood/tracks{
	dir = 4
	},
/obj/machinery/light/rogue/torchholder/c,
/turf/open/floor/rogue/blocks/green,
/area/rogue/outdoors/woods/churchfort/basement)
"tU" = (
/turf/closed/wall/mineral/rogue/stone,
/area/rogue/outdoors/woods/churchfort/basement)
"zO" = (
/turf/open/floor/rogue/tile/checkeralt,
/area/rogue/outdoors/woods/churchfort/basement)
"AQ" = (
/obj/effect/decal/cleanable/blood/tracks{
	dir = 10
	},
/turf/open/floor/rogue/cobble,
/area/rogue/outdoors/woods/churchfort/basement)
"Ce" = (
/mob/living/carbon/human/species/goblin/npc/ambush/cave,
/turf/open/floor/rogue/cobble,
/area/rogue/outdoors/woods/churchfort/basement)
"CW" = (
/turf/open/floor/rogue/cobble,
/area/rogue/outdoors/woods/churchfort/basement)
"Df" = (
/obj/structure/table/wood{
	icon_state = "largetable";
	dir = 6
	},
/obj/item/reagent_containers/glass/mortar,
/obj/item/pestle,
/turf/open/floor/rogue/tile/checkeralt,
/area/rogue/outdoors/woods/churchfort/basement)
"Dj" = (
/obj/structure/stairs/stone{
	dir = 1
	},
/obj/structure/fluff/railing/border{
	dir = 4
	},
/obj/structure/fluff/railing/border{
	dir = 8;
	icon_state = "border"
	},
/turf/open/floor/rogue/ruinedwood/turned,
/area/rogue/outdoors/woods/churchfort/basement)
"Fa" = (
/obj/machinery/light/rogue/torchholder/l,
/turf/open/floor/rogue/ruinedwood/turned,
/area/rogue/outdoors/woods/churchfort/basement)
"Fn" = (
/obj/machinery/gear_painter,
/turf/open/floor/rogue/ruinedwood/turned,
/area/rogue/outdoors/woods/churchfort/basement)
"Gm" = (
/obj/machinery/light/rogue/torchholder/l,
/turf/open/floor/rogue/blocks/green,
/area/rogue/outdoors/woods/churchfort/basement)
"Hm" = (
/obj/structure/fluff/railing/rampart,
/turf/open/floor/rogue/cobble,
/area/rogue/outdoors/woods/churchfort/basement)
"Kc" = (
/turf/open/floor/rogue/ruinedwood/turned,
/area/rogue/outdoors/woods/churchfort/basement)
"KC" = (
/turf/open/transparent/openspace,
/area/rogue/outdoors/woods/churchfort/basement)
"Lk" = (
/obj/structure/fluff/railing/rampart,
/turf/open/floor/rogue/blocks,
/area/rogue/outdoors/woods/churchfort/basement)
"LF" = (
/obj/structure/mineral_door/wood/donjon/stone{
	name = "Reagent Stores";
	dir = 1
	},
/turf/open/floor/rogue/blocks/green,
/area/rogue/outdoors/woods/churchfort/basement)
"MD" = (
/mob/living/carbon/human/species/goblin/npc/ambush/cave,
/turf/open/floor/rogue/ruinedwood/turned,
/area/rogue/outdoors/woods/churchfort/basement)
"MP" = (
/obj/effect/decal/cleanable/blood/tracks,
/turf/open/floor/rogue/blocks/green,
/area/rogue/outdoors/woods/churchfort/basement)
"OI" = (
/turf/open/floor/rogue/rooftop{
	dir = 4;
	icon_state = "roofg"
	},
/area/rogue/outdoors/woods/churchfort/basement)
"OK" = (
/obj/structure/closet/crate/chest/crate,
/obj/item/reagent_containers/glass/bottle/rogue,
/obj/item/reagent_containers/glass/bottle/rogue,
/obj/item/reagent_containers/glass/bottle/rogue,
/obj/item/reagent_containers/glass/bottle/rogue,
/obj/item/reagent_containers/glass/bottle/rogue,
/obj/item/reagent_containers/glass/bottle/rogue,
/obj/item/reagent_containers/glass/bottle/rogue,
/obj/item/reagent_containers/glass/bottle/rogue,
/obj/item/reagent_containers/glass/bottle/rogue,
/obj/item/reagent_containers/glass/bottle/rogue,
/turf/open/floor/rogue/cobble,
/area/rogue/outdoors/woods/churchfort/basement)
"OQ" = (
/obj/machinery/light/rogue/torchholder/r,
/obj/structure/trap/spider,
/turf/open/floor/rogue/tile/checkeralt,
/area/rogue/outdoors/woods/churchfort/basement)
"PW" = (
/obj/structure/closet/crate/chest/crate,
/obj/item/natural/bundle/silk{
	pixel_x = -5;
	amount = 6
	},
/obj/item/natural/bundle/silk{
	amount = 6
	},
/obj/item/natural/bundle/silk{
	pixel_x = 5;
	amount = 6
	},
/turf/open/floor/rogue/ruinedwood/turned,
/area/rogue/outdoors/woods/churchfort/basement)
"Rz" = (
/obj/structure/fluff/railing/rampart,
/turf/open/floor/rogue/rooftop{
	dir = 4;
	icon_state = "roofg"
	},
/area/rogue/outdoors/woods/churchfort/basement)
"RN" = (
/obj/structure/closet/crate/chest/crate,
/obj/item/reagent_containers/food/snacks/grown/berries/rogue/poison,
/obj/item/reagent_containers/food/snacks/grown/berries/rogue/poison,
/obj/item/reagent_containers/food/snacks/grown/berries/rogue/poison,
/obj/item/reagent_containers/food/snacks/grown/berries/rogue/poison,
/obj/item/reagent_containers/food/snacks/grown/berries/rogue/poison,
/obj/item/reagent_containers/food/snacks/grown/berries/rogue,
/obj/item/reagent_containers/food/snacks/grown/berries/rogue,
/obj/item/reagent_containers/food/snacks/grown/berries/rogue,
/obj/item/reagent_containers/food/snacks/grown/berries/rogue,
/obj/item/reagent_containers/food/snacks/grown/berries/rogue,
/obj/effect/decal/cleanable/ash,
/obj/effect/decal/cleanable/ash,
/obj/effect/decal/cleanable/ash,
/obj/effect/decal/cleanable/ash,
/obj/effect/decal/cleanable/ash,
/turf/open/floor/rogue/blocks/green,
/area/rogue/outdoors/woods/churchfort/basement)
"SN" = (
/mob/living/carbon/human/species/goblin/npc/ambush/cave,
/turf/open/floor/rogue/blocks,
/area/rogue/outdoors/woods/churchfort/basement)
"Tk" = (
/obj/structure/mineral_door/wood/donjon/stone{
	dir = 8;
	name = "South-East Tower"
	},
/turf/open/floor/rogue/ruinedwood/turned,
/area/rogue/outdoors/woods/churchfort/basement)
"Uu" = (
/obj/effect/decal/cleanable/blood,
/turf/open/floor/rogue/blocks/green,
/area/rogue/outdoors/woods/churchfort/basement)
"UL" = (
/obj/structure/table/wood{
	dir = 10;
	icon_state = "largetable"
	},
/obj/structure/fluff/millstone{
	pixel_y = 7
	},
/turf/open/floor/rogue/cobble,
/area/rogue/outdoors/woods/churchfort/basement)
"Vq" = (
/obj/structure/closet/crate/chest/crate,
/obj/item/reagent_containers/powder/ozium,
/obj/item/reagent_containers/powder/ozium,
/obj/item/reagent_containers/powder/ozium,
/obj/item/reagent_containers/glass/bottle/rogue/healthpot,
/obj/item/reagent_containers/glass/bottle/rogue/healthpot,
/obj/item/reagent_containers/glass/bottle/rogue/healthpot,
/obj/item/needle,
/obj/item/needle,
/turf/open/floor/rogue/blocks/green,
/area/rogue/outdoors/woods/churchfort/basement)
"Wj" = (
/obj/structure/trap/spider,
/turf/open/floor/rogue/blocks/green,
/area/rogue/outdoors/woods/churchfort/basement)
"WZ" = (
/obj/machinery/light/rogue/lanternpost{
	pixel_y = 28
	},
/turf/open/floor/rogue/cobble,
/area/rogue/outdoors/woods/churchfort/basement)

(1,1,1) = {"
KC
KC
KC
KC
KC
KC
oA
Rz
SN
rZ
Hm
OI
KC
KC
KC
"}
(2,1,1) = {"
KC
KC
KC
KC
KC
KC
oA
Rz
CW
rZ
Lk
OI
KC
KC
KC
"}
(3,1,1) = {"
KC
KC
KC
KC
KC
KC
oA
Rz
WZ
CW
Lk
OI
cz
KC
KC
"}
(4,1,1) = {"
KC
KC
KC
KC
KC
KC
oA
Rz
rZ
rZ
Lk
OI
KC
KC
KC
"}
(5,1,1) = {"
KC
KC
KC
KC
KC
tU
cf
cf
kD
Tk
kD
tU
tU
cf
KC
"}
(6,1,1) = {"
cf
la
tU
la
tU
tU
qY
cA
Kc
Kc
Kc
Fa
rl
cf
pU
"}
(7,1,1) = {"
CW
dd
dd
dd
dd
kD
Kc
MD
Kc
Kc
Kc
MD
PW
cf
pU
"}
(8,1,1) = {"
MP
AQ
CW
CW
dd
fz
Kc
Kc
Kc
MD
Kc
Kc
by
cf
pU
"}
(9,1,1) = {"
cf
tB
dd
dd
cf
cf
Kc
Kc
Kc
fT
Kc
Kc
Fn
tU
pU
"}
(10,1,1) = {"
eO
gH
AQ
dd
Vq
cf
Kc
Dj
oU
tU
cf
eh
tU
tU
pU
"}
(11,1,1) = {"
eO
dd
Uu
CW
Ce
tU
tU
cf
cf
tU
Wj
dd
UL
tU
pU
"}
(12,1,1) = {"
cf
oO
ro
as
ro
tU
an
Gm
dd
LF
dd
zO
Df
tU
pU
"}
(13,1,1) = {"
cf
cf
cf
tU
tU
tU
RN
fo
OK
tU
rt
OQ
ji
cf
pU
"}
(14,1,1) = {"
pU
pU
pU
pU
pU
tU
cf
cf
tU
tU
cf
tU
cf
cf
pU
"}
(15,1,1) = {"
pU
pU
pU
pU
pU
pU
pU
pU
pU
pU
pU
pU
pU
pU
pU
"}
