//MAP CONVERTED BY dmm2tgm.py THIS HEADER COMMENT PREVENTS RECONVERSION, DO NOT REMOVE
"aH" = (
/turf/open/transparent/openspace,
/area/rogue/outdoors/woods/churchfort/basement)
"aU" = (
/obj/structure/fluff/railing/border{
	dir = 4
	},
/obj/structure/fluff/railing/border{
	dir = 8;
	icon_state = "border"
	},
/obj/structure/fluff/railing/border,
/turf/open/transparent/openspace,
/area/rogue/outdoors/woods/churchfort/basement)
"dK" = (
/obj/machinery/light/rogue/torchholder/l,
/turf/open/floor/rogue/ruinedwood/turned,
/area/rogue/outdoors/woods/churchfort/basement)
"fK" = (
/mob/living/simple_animal/hostile/retaliate/rogue/orc,
/turf/open/floor/rogue/ruinedwood/turned,
/area/rogue/outdoors/woods/churchfort/basement)
"fY" = (
/obj/structure/trap/skeleton,
/turf/open/floor/rogue/tile/checkeralt,
/area/rogue/outdoors/woods/churchfort/basement)
"gI" = (
/obj/structure/fluff/walldeco/katholikos_banner{
	pixel_y = 25
	},
/turf/open/transparent/openspace,
/area/rogue/outdoors/woods/churchfort/basement)
"hc" = (
/obj/structure/fluff/littlebanners/elemental,
/turf/open/transparent/openspace,
/area/rogue/outdoors/woods/churchfort/basement)
"jl" = (
/obj/structure/stairs/stone{
	dir = 1
	},
/obj/structure/fluff/railing/border{
	dir = 4
	},
/obj/structure/fluff/railing/border{
	dir = 8;
	icon_state = "border"
	},
/turf/open/floor/rogue/ruinedwood/turned,
/area/rogue/outdoors/woods/churchfort/basement)
"jr" = (
/obj/structure/curtain/bounty{
	color = "grey"
	},
/turf/open/floor/rogue/tile/checkeralt,
/area/rogue/outdoors/woods/churchfort/basement)
"lx" = (
/obj/structure/closet/crate/chest/crate,
/obj/item/natural/bundle/silk{
	pixel_x = -5;
	amount = 6
	},
/obj/item/natural/bundle/silk{
	amount = 6
	},
/obj/item/natural/bundle/silk{
	pixel_x = 5;
	amount = 6
	},
/turf/open/floor/rogue/ruinedwood/turned,
/area/rogue/outdoors/woods/churchfort/basement)
"lC" = (
/obj/structure/mineral_door/wood/donjon/stone{
	name = "Reagent Stores";
	dir = 1
	},
/turf/open/floor/rogue/blocks/green,
/area/rogue/outdoors/woods/churchfort/basement)
"lW" = (
/obj/structure/fluff/alch,
/turf/open/floor/rogue/tile/checkeralt,
/area/rogue/outdoors/woods/churchfort/basement)
"mb" = (
/obj/structure/mineral_door/wood/donjon/stone{
	name = "Infirmary"
	},
/turf/open/floor/rogue/ruinedwood/turned,
/area/rogue/outdoors/woods/churchfort/basement)
"mV" = (
/obj/effect/decal/cleanable/blood/tracks{
	dir = 10
	},
/turf/open/floor/rogue/cobble,
/area/rogue/outdoors/woods/churchfort/basement)
"nN" = (
/turf/open/floor/rogue/cobble,
/area/rogue/outdoors/woods/churchfort/basement)
"nS" = (
/obj/structure/fluff/dryingrack,
/turf/open/floor/rogue/cobble,
/area/rogue/outdoors/woods/churchfort/basement)
"oy" = (
/obj/effect/decal/cleanable/blood/tracks{
	dir = 5
	},
/turf/open/floor/rogue/blocks/green,
/area/rogue/outdoors/woods/churchfort/basement)
"oU" = (
/obj/structure/roguewindow,
/turf/open/floor/rogue/blocks/bluestone,
/area/rogue/outdoors/woods/churchfort/basement)
"rp" = (
/obj/structure/mineral_door/wood/donjon/stone{
	name = "Alchemy";
	dir = 4
	},
/turf/open/floor/rogue/ruinedwood/turned,
/area/rogue/outdoors/woods/churchfort/basement)
"ry" = (
/obj/structure/roguewindow/openclose{
	icon_state = "woodwindowdir";
	dir = 4
	},
/turf/open/floor/rogue/blocks/bluestone,
/area/rogue/outdoors/woods/churchfort/basement)
"rJ" = (
/mob/living/simple_animal/hostile/retaliate/rogue/orc/ranged,
/turf/open/floor/rogue/ruinedwood/turned,
/area/rogue/outdoors/woods/churchfort/basement)
"sn" = (
/turf/open/floor/rogue/ruinedwood/turned,
/area/rogue/outdoors/woods/churchfort/basement)
"sL" = (
/obj/structure/fluff/railing/rampart,
/turf/open/floor/rogue/blocks,
/area/rogue/outdoors/woods/churchfort/basement)
"sO" = (
/obj/structure/closet/crate/chest/crate,
/obj/item/reagent_containers/powder/ozium,
/obj/item/reagent_containers/powder/ozium,
/obj/item/reagent_containers/powder/ozium,
/obj/item/reagent_containers/glass/bottle/rogue/healthpot,
/obj/item/reagent_containers/glass/bottle/rogue/healthpot,
/obj/item/reagent_containers/glass/bottle/rogue/healthpot,
/obj/item/needle,
/obj/item/needle,
/turf/open/floor/rogue/blocks/green,
/area/rogue/outdoors/woods/churchfort/basement)
"tr" = (
/obj/structure/bed/rogue/inn/hay,
/obj/structure/curtain/bounty{
	color = "grey"
	},
/turf/open/floor/rogue/blocks/green,
/area/rogue/outdoors/woods/churchfort/basement)
"wc" = (
/obj/structure/fluff/dryingrack,
/obj/machinery/light/rogue/torchholder/l,
/turf/open/floor/rogue/ruinedwood/turned,
/area/rogue/outdoors/woods/churchfort/basement)
"wg" = (
/obj/structure/table/wood{
	icon_state = "largetable";
	dir = 6
	},
/obj/item/reagent_containers/glass/mortar,
/obj/item/pestle,
/turf/open/floor/rogue/tile/checkeralt,
/area/rogue/outdoors/woods/churchfort/basement)
"yQ" = (
/obj/machinery/light/rogue/torchholder/r,
/turf/open/floor/rogue/blocks/green,
/area/rogue/outdoors/woods/churchfort/basement)
"BT" = (
/obj/structure/closet/crate/chest/crate,
/obj/item/reagent_containers/glass/bottle/rogue,
/obj/item/reagent_containers/glass/bottle/rogue,
/obj/item/reagent_containers/glass/bottle/rogue,
/obj/item/reagent_containers/glass/bottle/rogue,
/obj/item/reagent_containers/glass/bottle/rogue,
/obj/item/reagent_containers/glass/bottle/rogue,
/obj/item/reagent_containers/glass/bottle/rogue,
/obj/item/reagent_containers/glass/bottle/rogue,
/obj/item/reagent_containers/glass/bottle/rogue,
/obj/item/reagent_containers/glass/bottle/rogue,
/turf/open/floor/rogue/cobble,
/area/rogue/outdoors/woods/churchfort/basement)
"BW" = (
/mob/living/simple_animal/hostile/retaliate/rogue/orc/spear,
/turf/open/floor/rogue/ruinedwood/turned,
/area/rogue/outdoors/woods/churchfort/basement)
"CW" = (
/turf/closed/wall/mineral/rogue/stone,
/area/rogue/outdoors/woods/churchfort/basement)
"Dg" = (
/obj/structure/fluff/railing/rampart,
/turf/open/floor/rogue/cobble,
/area/rogue/outdoors/woods/churchfort/basement)
"EE" = (
/obj/structure/closet/crate/chest/crate,
/obj/item/reagent_containers/food/snacks/grown/berries/rogue/poison,
/obj/item/reagent_containers/food/snacks/grown/berries/rogue/poison,
/obj/item/reagent_containers/food/snacks/grown/berries/rogue/poison,
/obj/item/reagent_containers/food/snacks/grown/berries/rogue/poison,
/obj/item/reagent_containers/food/snacks/grown/berries/rogue/poison,
/obj/item/reagent_containers/food/snacks/grown/berries/rogue,
/obj/item/reagent_containers/food/snacks/grown/berries/rogue,
/obj/item/reagent_containers/food/snacks/grown/berries/rogue,
/obj/item/reagent_containers/food/snacks/grown/berries/rogue,
/obj/item/reagent_containers/food/snacks/grown/berries/rogue,
/obj/effect/decal/cleanable/ash,
/obj/effect/decal/cleanable/ash,
/obj/effect/decal/cleanable/ash,
/obj/effect/decal/cleanable/ash,
/obj/effect/decal/cleanable/ash,
/turf/open/floor/rogue/blocks/green,
/area/rogue/outdoors/woods/churchfort/basement)
"GN" = (
/obj/effect/decal/cleanable/blood/tracks{
	dir = 4
	},
/obj/machinery/light/rogue/torchholder/c,
/mob/living/simple_animal/hostile/retaliate/rogue/orc,
/turf/open/floor/rogue/blocks/green,
/area/rogue/outdoors/woods/churchfort/basement)
"GQ" = (
/obj/structure/closet/crate/chest/crate,
/obj/item/natural/bundle/fibers/full{
	pixel_x = -5
	},
/obj/item/natural/bundle/fibers/full,
/obj/item/natural/bundle/fibers/full{
	pixel_x = 5
	},
/obj/item/natural/bundle/fibers/full{
	pixel_x = -5
	},
/obj/item/natural/bundle/fibers/full,
/obj/item/natural/bundle/fibers/full{
	pixel_x = 5
	},
/turf/open/floor/rogue/ruinedwood/turned,
/area/rogue/outdoors/woods/churchfort/basement)
"GT" = (
/obj/effect/decal/cleanable/blood/tracks,
/turf/open/floor/rogue/blocks/green,
/area/rogue/outdoors/woods/churchfort/basement)
"Ht" = (
/obj/effect/decal/cleanable/blood,
/turf/open/floor/rogue/blocks/green,
/area/rogue/outdoors/woods/churchfort/basement)
"Hw" = (
/obj/structure/closet/crate/chest/crate,
/obj/item/reagent_containers/food/snacks/grown/rogue/sweetleaf,
/obj/item/reagent_containers/food/snacks/grown/rogue/sweetleaf,
/obj/item/reagent_containers/food/snacks/grown/rogue/sweetleaf,
/obj/item/reagent_containers/food/snacks/grown/rogue/sweetleaf,
/obj/item/reagent_containers/food/snacks/grown/rogue/sweetleaf,
/obj/item/reagent_containers/food/snacks/grown/rogue/pipeweed,
/obj/item/reagent_containers/food/snacks/grown/rogue/pipeweed,
/obj/item/reagent_containers/food/snacks/grown/rogue/pipeweed,
/obj/item/reagent_containers/food/snacks/grown/rogue/pipeweed,
/obj/item/reagent_containers/food/snacks/grown/rogue/pipeweed,
/obj/item/reagent_containers/food/snacks/grown/rogue/fyritius,
/obj/item/reagent_containers/food/snacks/grown/rogue/fyritius,
/obj/item/reagent_containers/food/snacks/grown/rogue/fyritius,
/obj/item/reagent_containers/food/snacks/grown/rogue/fyritius,
/obj/item/reagent_containers/food/snacks/grown/rogue/fyritius,
/turf/open/floor/rogue/blocks/green,
/area/rogue/outdoors/woods/churchfort/basement)
"HF" = (
/turf/open/floor/rogue/blocks,
/area/rogue/outdoors/woods/churchfort/basement)
"KC" = (
/turf/open/floor/rogue/grassyel,
/area/rogue/outdoors/woods/churchfort/basement)
"Lp" = (
/turf/open/floor/rogue/rooftop{
	dir = 4;
	icon_state = "roofg"
	},
/area/rogue/outdoors/woods/churchfort/basement)
"LP" = (
/turf/closed/wall/mineral/rogue/stone/moss,
/area/rogue/outdoors/woods/churchfort/basement)
"Mb" = (
/obj/machinery/gear_painter,
/turf/open/floor/rogue/ruinedwood/turned,
/area/rogue/outdoors/woods/churchfort/basement)
"Ml" = (
/obj/structure/table/wood{
	dir = 10;
	icon_state = "largetable"
	},
/obj/structure/fluff/millstone{
	pixel_y = 7
	},
/turf/open/floor/rogue/cobble,
/area/rogue/outdoors/woods/churchfort/basement)
"MW" = (
/obj/structure/trap/skeleton,
/turf/open/floor/rogue/cobble,
/area/rogue/outdoors/woods/churchfort/basement)
"NC" = (
/obj/structure/fluff/railing/rampart,
/turf/open/floor/rogue/rooftop{
	dir = 4;
	icon_state = "roofg"
	},
/area/rogue/outdoors/woods/churchfort/basement)
"NV" = (
/obj/machinery/light/rogue/lanternpost{
	pixel_y = 28
	},
/turf/open/floor/rogue/cobble,
/area/rogue/outdoors/woods/churchfort/basement)
"OD" = (
/mob/living/simple_animal/hostile/retaliate/rogue/orc/spear,
/turf/open/floor/rogue/cobble,
/area/rogue/outdoors/woods/churchfort/basement)
"OW" = (
/obj/machinery/light/rogue/torchholder/r,
/turf/open/floor/rogue/tile/checkeralt,
/area/rogue/outdoors/woods/churchfort/basement)
"Ph" = (
/turf/open/floor/rogue/blocks/green,
/area/rogue/outdoors/woods/churchfort/basement)
"Qq" = (
/obj/structure/closet/crate/chest/crate,
/obj/item/natural/hide,
/obj/item/natural/hide,
/obj/item/natural/hide,
/obj/item/natural/hide,
/obj/item/natural/hide,
/obj/item/natural/hide,
/obj/item/natural/hide,
/obj/item/natural/hide,
/obj/item/natural/hide,
/obj/item/natural/hide,
/obj/item/natural/hide,
/obj/item/natural/hide,
/obj/item/natural/hide,
/obj/item/natural/hide,
/turf/open/floor/rogue/ruinedwood/turned,
/area/rogue/outdoors/woods/churchfort/basement)
"QY" = (
/obj/effect/decal/cleanable/cobweb{
	icon_state = "cobweb2"
	},
/turf/open/floor/rogue/blocks/green,
/area/rogue/outdoors/woods/churchfort/basement)
"RS" = (
/obj/machinery/light/rogue/torchholder/l,
/turf/open/floor/rogue/blocks/green,
/area/rogue/outdoors/woods/churchfort/basement)
"St" = (
/mob/living/simple_animal/hostile/retaliate/rogue/orc/orc2,
/turf/open/floor/rogue/blocks,
/area/rogue/outdoors/woods/churchfort/basement)
"Tl" = (
/obj/structure/mineral_door/wood/donjon/stone{
	dir = 8;
	name = "South-East Tower"
	},
/turf/open/floor/rogue/ruinedwood/turned,
/area/rogue/outdoors/woods/churchfort/basement)
"Tv" = (
/obj/machinery/loom,
/turf/open/floor/rogue/ruinedwood/turned,
/area/rogue/outdoors/woods/churchfort/basement)
"Un" = (
/obj/machinery/light/rogue/torchholder/r,
/turf/open/floor/rogue/ruinedwood/turned,
/area/rogue/outdoors/woods/churchfort/basement)

(1,1,1) = {"
aH
aH
aH
aH
aH
aH
hc
NC
St
HF
Dg
Lp
aH
aH
aH
"}
(2,1,1) = {"
aH
aH
aH
aH
aH
aH
hc
NC
nN
HF
sL
Lp
aH
aH
aH
"}
(3,1,1) = {"
aH
aH
aH
aH
aH
aH
hc
NC
NV
nN
sL
Lp
gI
aH
aH
"}
(4,1,1) = {"
aH
aH
aH
aH
aH
aH
hc
NC
HF
HF
sL
Lp
aH
aH
aH
"}
(5,1,1) = {"
aH
aH
aH
aH
aH
CW
LP
LP
oU
Tl
oU
CW
CW
LP
aH
"}
(6,1,1) = {"
LP
ry
CW
ry
CW
CW
Qq
wc
sn
sn
sn
dK
GQ
LP
KC
"}
(7,1,1) = {"
nN
Ph
Ph
Ph
Ph
oU
sn
fK
sn
sn
sn
rJ
lx
LP
KC
"}
(8,1,1) = {"
GT
mV
nN
nN
Ph
mb
sn
sn
sn
BW
sn
sn
Tv
LP
KC
"}
(9,1,1) = {"
LP
GN
Ph
Ph
LP
LP
sn
sn
sn
Un
sn
sn
Mb
CW
KC
"}
(10,1,1) = {"
jr
oy
mV
Ph
sO
LP
sn
jl
aU
CW
LP
rp
CW
CW
KC
"}
(11,1,1) = {"
jr
Ph
Ht
nN
OD
CW
CW
LP
LP
CW
Ph
Ph
Ml
CW
KC
"}
(12,1,1) = {"
LP
QY
tr
yQ
tr
CW
MW
RS
Ph
lC
Ph
fY
wg
CW
KC
"}
(13,1,1) = {"
LP
LP
LP
CW
CW
CW
EE
Hw
BT
CW
nS
OW
lW
LP
KC
"}
(14,1,1) = {"
KC
KC
KC
KC
KC
CW
LP
LP
CW
CW
LP
CW
LP
LP
KC
"}
(15,1,1) = {"
KC
KC
KC
KC
KC
KC
KC
KC
KC
KC
KC
KC
KC
KC
KC
"}
