//MAP CONVERTED BY dmm2tgm.py THIS HEADER COMMENT PREVENTS RECONVERSION, DO NOT REMOVE
"aJ" = (
/obj/item/natural/rock,
/turf/open/floor/rogue/naturalstone,
/area/rogue/under/cave)
"cs" = (
/obj/structure/table/wood{
	dir = 1;
	icon_state = "longtable_mid"
	},
/obj/item/paper,
/turf/open/floor/rogue/ruinedwood,
/area/rogue/under/cave)
"cW" = (
/turf/open/floor/rogue/ruinedwood,
/area/rogue/under/cave)
"dE" = (
/turf/closed/mineral/random/rogue,
/area/rogue/under/cave)
"dF" = (
/obj/structure/rack/rogue/shelf/big{
	icon_state = "shelf_biggest";
	pixel_y = 0
	},
/obj/item/natural/feather,
/obj/item/natural/bundle/stick,
/obj/item/clothing/head/roguetown/helmet,
/turf/open/floor/rogue/cobble,
/area/rogue/under/cave)
"fC" = (
/turf/open/floor/rogue/naturalstone,
/area/rogue/under/cave)
"gB" = (
/obj/effect/decal/cobbleedge{
	dir = 10;
	icon_state = "cobbleedge-e"
	},
/obj/effect/decal/cobbleedge{
	icon_state = "cobbleedge-n"
	},
/turf/open/floor/rogue/ruinedwood,
/area/rogue/under/cave)
"ht" = (
/obj/structure/fluff/alch,
/turf/open/floor/rogue/ruinedwood,
/area/rogue/under/cave)
"hN" = (
/obj/item/natural/stone,
/turf/open/floor/rogue/naturalstone,
/area/rogue/under/cave)
"kd" = (
/obj/structure/closet/crate/chest/old_crate,
/obj/item/reagent_containers/food/snacks/grown/wheat,
/obj/item/reagent_containers/food/snacks/grown/wheat,
/obj/item/reagent_containers/food/snacks/grown/wheat,
/obj/item/rogueweapon/huntingknife/cleaver,
/obj/item/kitchen/rollingpin,
/obj/item/reagent_containers/glass/bucket/pot,
/obj/item/reagent_containers/glass/cup/wooden,
/obj/item/reagent_containers/glass/cup/wooden,
/turf/open/floor/rogue/cobble,
/area/rogue/under/cave)
"nu" = (
/obj/effect/decal/cobbleedge{
	icon_state = "cobbleedge-n"
	},
/obj/effect/decal/cobbleedge{
	dir = 10;
	icon_state = "cobbleedge-e"
	},
/turf/open/floor/rogue/ruinedwood,
/area/rogue/under/cave)
"qv" = (
/obj/structure/mineral_door/wood/donjon{
	dir = 1
	},
/turf/open/floor/rogue/ruinedwood,
/area/rogue/under/cave)
"qC" = (
/turf/closed/wall/mineral/rogue/wooddark,
/area/rogue/under/cave)
"qK" = (
/obj/machinery/light/rogue/torchholder/l,
/obj/item/cooking/platter,
/obj/effect/mist,
/obj/item/natural/bundle/bone,
/turf/open/floor/rogue/cobble,
/area/rogue/under/cave)
"qX" = (
/obj/item/reagent_containers/glass/bucket/wooden{
	pixel_x = -6;
	pixel_y = 15
	},
/turf/open/floor/rogue/cobble,
/area/rogue/under/cave)
"sC" = (
/obj/item/natural/silk,
/obj/effect/mist,
/obj/structure/rack/rogue/shelf/big{
	icon_state = "shelf_biggest";
	pixel_y = 0
	},
/obj/item/rope/chain,
/obj/structure/fluff/walldeco/chains,
/turf/open/floor/rogue/cobble,
/area/rogue/under/cave)
"uj" = (
/obj/effect/mist,
/turf/open/water/pond{
	name = "hotspring";
	desc = "Bubbly and warm!"
	},
/area/rogue/under/cave)
"yf" = (
/obj/machinery/light/rogue/torchholder/c,
/turf/open/floor/rogue/naturalstone,
/area/rogue/under/cave)
"yr" = (
/obj/machinery/light/rogue/torchholder/c,
/obj/machinery/light/rogue/hearth,
/obj/item/cooking/pan,
/turf/open/floor/rogue/cobble,
/area/rogue/under/cave)
"Ae" = (
/obj/item/natural/stone,
/obj/machinery/light/rogue/torchholder/l,
/turf/open/floor/rogue/naturalstone,
/area/rogue/under/cave)
"AW" = (
/obj/structure/roguetent,
/turf/open/floor/rogue/cobble,
/area/rogue/under/cave)
"Cw" = (
/turf/open/floor/rogue/cobble,
/area/rogue/under/cave)
"Cy" = (
/obj/effect/decal/cobbleedge{
	icon_state = "cobbleedge-n"
	},
/turf/open/floor/rogue/ruinedwood,
/area/rogue/under/cave)
"Dd" = (
/turf/closed/wall/mineral/rogue/tent,
/area/rogue/under/cave)
"GL" = (
/obj/structure/bed/rogue/inn/wool,
/obj/item/bedsheet/rogue/cloth,
/obj/effect/spawner/lootdrop/roguetown/dungeon/clothing,
/turf/open/floor/rogue/cobble,
/area/rogue/under/cave)
"KC" = (
/obj/structure/rack/rogue/shelf/big{
	icon_state = "shelf_biggest";
	pixel_y = 0
	},
/obj/item/paper,
/obj/item/rogueweapon/sword/iron/short,
/obj/item/roguecoin/copper/pile,
/turf/open/floor/rogue/cobble,
/area/rogue/under/cave)
"Nu" = (
/obj/item/natural/fibers,
/turf/open/floor/rogue/naturalstone,
/area/rogue/under/cave)
"RY" = (
/obj/structure/table/wood{
	icon_state = "longtable";
	dir = 1
	},
/obj/item/reagent_containers/glass/bottle/rogue/wine{
	pixel_x = -16
	},
/obj/effect/spawner/lootdrop/roguetown/alcohol/average,
/turf/open/floor/rogue/ruinedwood,
/area/rogue/under/cave)
"TX" = (
/obj/item/grown/log/tree/stick,
/obj/effect/decal/cobbleedge{
	icon_state = "cobbleedge-n"
	},
/turf/open/floor/rogue/ruinedwood,
/area/rogue/under/cave)
"Vs" = (
/obj/item/roguecoin/copper,
/obj/effect/mist,
/turf/open/water/pond{
	name = "hotspring";
	desc = "Bubbly and warm!"
	},
/area/rogue/under/cave)
"YZ" = (
/obj/machinery/light/rogue/torchholder/c,
/turf/closed/wall/mineral/rogue/wooddark,
/area/rogue/under/cave)

(1,1,1) = {"
aJ
dE
dE
hN
fC
fC
fC
hN
fC
dE
"}
(2,1,1) = {"
dE
dE
qC
qC
qC
qC
qC
qC
Nu
fC
"}
(3,1,1) = {"
dE
sC
qK
AW
gB
cW
cs
qC
yf
aJ
"}
(4,1,1) = {"
dE
Vs
uj
Dd
kd
TX
RY
qC
fC
fC
"}
(5,1,1) = {"
dE
dE
qC
qC
yr
Cy
cW
qv
fC
fC
"}
(6,1,1) = {"
Ae
qC
dF
qX
Cw
nu
ht
qC
dE
hN
"}
(7,1,1) = {"
dE
qC
KC
Cw
qC
AW
qC
qC
dE
fC
"}
(8,1,1) = {"
dE
qC
qC
qC
YZ
Cw
GL
qC
fC
fC
"}
(9,1,1) = {"
dE
dE
dE
dE
qC
qC
qC
qC
hN
dE
"}
(10,1,1) = {"
dE
dE
fC
hN
fC
fC
aJ
fC
fC
dE
"}
